AAACCTGAGTCGTACT-1	YRI
AAACCTGAGTTACGGG-1	YRI
AAACCTGAGTTGTCGT-1	YRI
AAACCTGCATGCTAGT-1	YRI
AAACCTGTCAGCTTAG-1	YRI
AAACCTGTCCGTTGTC-1	CEU
AAACGGGAGAGGACGG-1	CEU
AAACGGGAGATGAGAG-1	YRI
AAACGGGAGCTGATAA-1	CEU
AAACGGGAGTACGCCC-1	YRI
AAACGGGAGTGCCAGA-1	CEU
AAACGGGGTTCCAACA-1	YRI
AAACGGGGTTGATTGC-1	YRI
AAACGGGTCAGTGTTG-1	YRI
AAACGGGTCCACTGGG-1	CEU
AAACGGGTCTCCAACC-1	YRI
AAAGATGAGAAACCGC-1	YRI
AAAGATGAGAAAGTGG-1	YRI
AAAGATGAGTGAACGC-1	CEU
AAAGATGCACAACTGT-1	YRI
AAAGATGCACGGATAG-1	YRI
AAAGATGCAGCTGCAC-1	CEU
AAAGATGCAGGTTTCA-1	YRI
AAAGATGCATCGGTTA-1	YRI
AAAGATGGTCCGTTAA-1	YRI
AAAGATGTCACAACGT-1	YRI
AAAGATGTCGCGCCAA-1	YRI
AAAGATGTCTGGTGTA-1	CEU
AAAGCAAAGACTCGGA-1	YRI
AAAGCAAAGACTTGAA-1	YRI
AAAGCAAAGATCGATA-1	YRI
AAAGCAAAGCTGCGAA-1	CEU
AAAGCAAAGGCTAGAC-1	YRI
AAAGCAAAGTAATCCC-1	YRI
AAAGCAAAGTGTGAAT-1	YRI
AAAGCAACAAGTCATC-1	CEU
AAAGCAACAGCCAGAA-1	CEU
AAAGCAACATGGAATA-1	CEU
AAAGCAAGTAAGGGAA-1	YRI
AAAGCAAGTCAACTGT-1	CEU
AAAGCAAGTTAAGATG-1	CEU
AAAGCAAGTTGGTAAA-1	YRI
AAAGCAATCAGGATCT-1	YRI
AAAGCAATCGAACGGA-1	YRI
AAAGCAATCTACCTGC-1	YRI
AAAGCAATCTGTTTGT-1	YRI
AAAGTAGAGTAGGTGC-1	YRI
AAAGTAGAGTATGACA-1	YRI
AAAGTAGAGTCAATAG-1	YRI
AAAGTAGAGTCTCAAC-1	CEU
AAAGTAGAGTTAGGTA-1	YRI
AAAGTAGCACTTAAGC-1	YRI
AAAGTAGGTAATTGGA-1	CEU
AAAGTAGGTCCGAAGA-1	YRI
AAAGTAGGTCGACTGC-1	CEU
AAAGTAGGTCGGGTCT-1	CEU
AAAGTAGGTCTAGGTT-1	YRI
AAAGTAGGTGTTAAGA-1	YRI
AAAGTAGGTTCACGGC-1	YRI
AAAGTAGTCATGCAAC-1	YRI
AAAGTAGTCCGCATCT-1	YRI
AAAGTAGTCCTTAATC-1	YRI
AAAGTAGTCTGCGACG-1	CEU
AAATGCCAGAGTGACC-1	YRI
AAATGCCAGCCGCCTA-1	CEU
AAATGCCAGGGTGTGT-1	CEU
AAATGCCCAAACCTAC-1	CEU
AAATGCCCAGTGACAG-1	CEU
AAATGCCGTGATGATA-1	YRI
AAATGCCGTTCCATGA-1	CEU
AAATGCCTCAATACCG-1	YRI
AAATGCCTCGGAATCT-1	YRI
AAATGCCTCTTGCCGT-1	CEU
AACACGTAGACCACGA-1	CEU
AACACGTAGCTAGTTC-1	YRI
AACACGTAGTCGAGTG-1	YRI
AACACGTCACAGATTC-1	YRI
AACACGTCAGGCTCAC-1	YRI
AACACGTCAGGGTACA-1	YRI
AACACGTCAGGGTATG-1	YRI
AACACGTCATGAACCT-1	CEU
AACACGTGTACTTGAC-1	YRI
AACACGTGTCTCACCT-1	YRI
AACACGTGTTCGGGCT-1	YRI
AACACGTTCATGCATG-1	CEU
AACACGTTCTTCAACT-1	CEU
AACCATGAGGACATTA-1	CEU
AACCATGAGGCTCATT-1	CEU
AACCATGAGTTCGCAT-1	YRI
AACCATGCAGGTCTCG-1	CEU
AACCATGCATATGGTC-1	CEU
AACCATGGTACAGACG-1	CEU
AACCATGGTTCGTCTC-1	CEU
AACCATGTCCACGACG-1	YRI
AACCGCGAGTGAAGAG-1	CEU
AACCGCGAGTTGTAGA-1	CEU
AACCGCGAGTTGTCGT-1	CEU
AACCGCGCACGGTTTA-1	YRI
AACCGCGGTACCTACA-1	CEU
AACCGCGGTCTTCGTC-1	YRI
AACCGCGGTTGAGTTC-1	CEU
AACCGCGGTTGATTCG-1	CEU
AACCGCGTCCGCGCAA-1	YRI
AACGTTGAGCCATCGC-1	CEU
AACGTTGCAAACTGTC-1	YRI
AACGTTGCAAATACAG-1	YRI
AACGTTGCACCATCCT-1	CEU
AACGTTGCACCGGAAA-1	CEU
AACGTTGGTCTCCATC-1	YRI
AACGTTGGTGACAAAT-1	CEU
AACGTTGGTTGGAGGT-1	CEU
AACTCAGAGTAAGTAC-1	CEU
AACTCAGCAAGGACAC-1	CEU
AACTCAGCAATCCGAT-1	YRI
AACTCAGCAATTCCTT-1	CEU
AACTCAGCAGACAAAT-1	CEU
AACTCAGGTAGCGCAA-1	YRI
AACTCAGGTGGCGAAT-1	CEU
AACTCAGTCAAAGACA-1	YRI
AACTCAGTCAATCTCT-1	YRI
AACTCAGTCACATAGC-1	YRI
AACTCAGTCAGGCAAG-1	CEU
AACTCAGTCATGCAAC-1	YRI
AACTCAGTCCATGAGT-1	YRI
AACTCAGTCGTTGACA-1	YRI
AACTCCCAGGAACTGC-1	YRI
AACTCCCAGGACAGAA-1	YRI
AACTCCCAGTGGTAAT-1	YRI
AACTCCCAGTTGTAGA-1	YRI
AACTCCCGTGACCAAG-1	CEU
AACTCCCGTTCCAACA-1	YRI
AACTCCCTCAAGAAGT-1	YRI
AACTCCCTCAATCTCT-1	CEU
AACTCCCTCCATGAAC-1	YRI
AACTCCCTCCGGCACA-1	YRI
AACTCCCTCCGTACAA-1	YRI
AACTCCCTCGGTGTCG-1	CEU
AACTCCCTCTGTGCAA-1	YRI
AACTCTTAGCGATAGC-1	YRI
AACTCTTAGCTTCGCG-1	CEU
AACTCTTAGGGCATGT-1	YRI
AACTCTTAGTTGCAGG-1	CEU
AACTCTTCAAACCCAT-1	YRI
AACTCTTCACCACGTG-1	YRI
AACTCTTCAGCGATCC-1	CEU
AACTCTTCAGTGGGAT-1	CEU
AACTCTTCATATACGC-1	YRI
AACTCTTGTATATGAG-1	CEU
AACTCTTGTCGAACAG-1	CEU
AACTCTTGTGACAAAT-1	CEU
AACTCTTGTTCGCGAC-1	YRI
AACTCTTTCAGGTAAA-1	CEU
AACTCTTTCCACTGGG-1	CEU
AACTCTTTCGAACTGT-1	CEU
AACTGGTAGATAGTCA-1	CEU
AACTGGTCAGACGCAA-1	CEU
AACTGGTCAGTTTACG-1	CEU
AACTGGTGTACGACCC-1	YRI
AACTGGTGTCGGCTCA-1	CEU
AACTGGTGTCTCTTTA-1	YRI
AACTGGTGTCTTGTCC-1	YRI
AACTGGTGTGGACGAT-1	YRI
AACTGGTTCCTAGGGC-1	YRI
AACTGGTTCGTCTGAA-1	CEU
AACTTTCAGGAATTAC-1	CEU
AACTTTCAGGAGTTTA-1	YRI
AACTTTCAGGTTCCTA-1	YRI
AACTTTCCAAGCCGTC-1	YRI
AACTTTCCAATACGCT-1	YRI
AACTTTCCACACCGCA-1	YRI
AACTTTCCATAAAGGT-1	YRI
AACTTTCGTAAGGGAA-1	YRI
AACTTTCGTATATGAG-1	CEU
AACTTTCGTGCAGTAG-1	YRI
AACTTTCGTTTAGGAA-1	YRI
AACTTTCGTTTGCATG-1	YRI
AACTTTCTCATTTGGG-1	YRI
AACTTTCTCTGGTTCC-1	YRI
AAGACCTAGCGAGAAA-1	CEU
AAGACCTAGGCTAGGT-1	YRI
AAGACCTAGTGCCATT-1	CEU
AAGACCTCAAAGCGGT-1	YRI
AAGACCTCACGAGAGT-1	YRI
AAGACCTCAGCTGTGC-1	CEU
AAGACCTCATCCGTGG-1	CEU
AAGACCTGTATTAGCC-1	CEU
AAGACCTGTTATCACG-1	YRI
AAGACCTGTTATTCTC-1	CEU
AAGCCGCAGCCCAGCT-1	YRI
AAGCCGCCATCACGTA-1	YRI
AAGCCGCGTCCAAGTT-1	YRI
AAGCCGCTCGAGAGCA-1	YRI
AAGCCGCTCGGTCTAA-1	YRI
AAGGAGCAGAACAATC-1	CEU
AAGGAGCAGCTACCGC-1	YRI
AAGGAGCAGTTACGGG-1	YRI
AAGGAGCAGTTCGCAT-1	YRI
AAGGAGCAGTTTCCTT-1	CEU
AAGGAGCCAAGCTGTT-1	YRI
AAGGAGCCACTACAGT-1	YRI
AAGGAGCCAGGCGATA-1	YRI
AAGGAGCCATGCCTAA-1	YRI
AAGGAGCGTATCACCA-1	YRI
AAGGAGCGTCTAGCCG-1	YRI
AAGGAGCGTGTTCGAT-1	YRI
AAGGAGCGTTTAAGCC-1	CEU
AAGGAGCTCACGGTTA-1	CEU
AAGGAGCTCGATAGAA-1	CEU
AAGGAGCTCGTCCAGG-1	CEU
AAGGCAGAGCTAAACA-1	YRI
AAGGCAGAGGATATAC-1	YRI
AAGGCAGCACGTAAGG-1	YRI
AAGGCAGCACGTCAGC-1	YRI
AAGGCAGCAGATGAGC-1	CEU
AAGGCAGCAGGTGCCT-1	YRI
AAGGCAGCATGAACCT-1	CEU
AAGGCAGGTTGAACTC-1	YRI
AAGGCAGTCTTGAGGT-1	YRI
AAGGTTCAGATCCTGT-1	YRI
AAGGTTCAGCCACGCT-1	CEU
AAGGTTCAGGTTCCTA-1	YRI
AAGGTTCAGTGGGATC-1	YRI
AAGGTTCCATCGATGT-1	YRI
AAGGTTCCATGTAGTC-1	YRI
AAGGTTCGTAAATACG-1	CEU
AAGGTTCGTATAAACG-1	YRI
AAGGTTCGTGACCAAG-1	CEU
AAGGTTCGTTACAGAA-1	CEU
AAGGTTCTCAAAGTAG-1	YRI
AAGGTTCTCCTGCCAT-1	YRI
AAGGTTCTCTATGTGG-1	CEU
AAGGTTCTCTTCGGTC-1	YRI
AAGGTTCTCTTGTACT-1	YRI
AAGTCTGAGAGCTATA-1	CEU
AAGTCTGAGCTAGGCA-1	YRI
AAGTCTGAGTGGGATC-1	CEU
AAGTCTGCACGTTGGC-1	YRI
AAGTCTGCATGCTGGC-1	YRI
AAGTCTGGTACAAGTA-1	YRI
AAGTCTGGTACCGGCT-1	YRI
AAGTCTGGTAGCGTAG-1	CEU
AAGTCTGGTTACGACT-1	YRI
AAGTCTGGTTCAGACT-1	CEU
AAGTCTGGTTGATTGC-1	YRI
AAGTCTGGTTTGACTG-1	0
AAGTCTGTCAAGGTAA-1	CEU
AAGTCTGTCACATAGC-1	YRI
AAGTCTGTCCGCGCAA-1	YRI
AAGTCTGTCGTTACGA-1	YRI
AAGTCTGTCGTTTGCC-1	CEU
AATCCAGAGACGACGT-1	YRI
AATCCAGAGCTCAACT-1	CEU
AATCCAGAGTCAAGGC-1	YRI
AATCCAGAGTGACATA-1	YRI
AATCCAGCACAACGCC-1	YRI
AATCCAGCACGGACAA-1	YRI
AATCCAGCACTACAGT-1	YRI
AATCCAGCAGACAAGC-1	CEU
AATCCAGCAGTAAGCG-1	CEU
AATCCAGCATGTCGAT-1	YRI
AATCCAGGTCCGTGAC-1	YRI
AATCCAGGTGTATGGG-1	CEU
AATCCAGGTGTTGGGA-1	YRI
AATCCAGGTTGTCTTT-1	YRI
AATCCAGTCCTGCTTG-1	YRI
AATCGGTAGGAGTACC-1	YRI
AATCGGTAGGCCATAG-1	CEU
AATCGGTAGTCCCACG-1	CEU
AATCGGTCAAGGACAC-1	CEU
AATCGGTCACCGAATT-1	CEU
AATCGGTCACGGACAA-1	YRI
AATCGGTCAGCTGCAC-1	YRI
AATCGGTCATAAGACA-1	YRI
AATCGGTCATTCCTCG-1	CEU
AATCGGTGTAAAGGAG-1	CEU
AATCGGTGTCTTGATG-1	YRI
AATCGGTGTGCACTTA-1	CEU
AATCGGTGTTAAGGGC-1	YRI
AATCGGTGTTGGACCC-1	CEU
AATCGGTTCACATAGC-1	YRI
AATCGGTTCCGTCATC-1	YRI
AATCGGTTCGCATGGC-1	CEU
AATCGGTTCTGCAGTA-1	YRI
ACACCAAAGAACAATC-1	YRI
ACACCAAAGGGAGTAA-1	YRI
ACACCAAAGTCCATAC-1	YRI
ACACCAACACTGTGTA-1	YRI
ACACCAACATTGGGCC-1	CEU
ACACCAAGTACAGCAG-1	YRI
ACACCAAGTAGGACAC-1	YRI
ACACCAATCAACACTG-1	YRI
ACACCAATCACCAGGC-1	YRI
ACACCAATCAGCACAT-1	CEU
ACACCAATCCAATGGT-1	CEU
ACACCAATCCCTAATT-1	YRI
ACACCAATCTTCATGT-1	YRI
ACACCCTAGGCCCTTG-1	CEU
ACACCCTAGGCGATAC-1	YRI
ACACCCTAGGTGGGTT-1	CEU
ACACCCTAGTAAGTAC-1	YRI
ACACCCTCACAAGTAA-1	CEU
ACACCCTCACACCGCA-1	CEU
ACACCCTTCCAGGGCT-1	CEU
ACACCCTTCCCGACTT-1	YRI
ACACCCTTCGGTGTTA-1	YRI
ACACCCTTCTGCGTAA-1	YRI
ACACCCTTCTGCTTGC-1	CEU
ACACCCTTCTGTTTGT-1	CEU
ACACCGGAGTGTACGG-1	CEU
ACACCGGAGTTGTCGT-1	CEU
ACACCGGCAAGGTGTG-1	YRI
ACACCGGCACAGGAGT-1	YRI
ACACCGGCAGGTGGAT-1	CEU
ACACCGGCATGGTCAT-1	CEU
ACACCGGGTAAGGGAA-1	CEU
ACACCGGGTAAGTGGC-1	CEU
ACACCGGGTCCGCTGA-1	YRI
ACACCGGGTCTAAAGA-1	YRI
ACACCGGGTGGTACAG-1	CEU
ACACCGGTCCAACCAA-1	YRI
ACACCGGTCGGTGTTA-1	YRI
ACACCGGTCTCACATT-1	CEU
ACACTGAAGCTGCGAA-1	YRI
ACACTGAAGGACAGCT-1	YRI
ACACTGAAGTGCGTGA-1	YRI
ACACTGACAAAGCGGT-1	YRI
ACACTGACAACGATCT-1	YRI
ACACTGACAAGAGTCG-1	YRI
ACACTGACACGTTGGC-1	CEU
ACACTGACACTGTTAG-1	YRI
ACACTGAGTATATCCG-1	YRI
ACACTGAGTGAGGGTT-1	YRI
ACACTGAGTGCTGTAT-1	YRI
ACAGCCGAGAGGGCTT-1	CEU
ACAGCCGAGCTACCGC-1	CEU
ACAGCCGAGGGTGTTG-1	CEU
ACAGCCGAGTCCGGTC-1	YRI
ACAGCCGCACAGACAG-1	CEU
ACAGCCGCAGGGAGAG-1	YRI
ACAGCCGCATAAAGGT-1	CEU
ACAGCCGCATTCTTAC-1	CEU
ACAGCCGCATTTCAGG-1	YRI
ACAGCCGGTGCAGGTA-1	CEU
ACAGCCGGTTACCGAT-1	YRI
ACAGCCGTCAAACCAC-1	CEU
ACAGCCGTCATAACCG-1	CEU
ACAGCTAAGACTGGGT-1	YRI
ACAGCTAAGTACTTGC-1	CEU
ACAGCTACAAGGTGTG-1	YRI
ACAGCTACAGACGTAG-1	YRI
ACAGCTACAGCCTTGG-1	YRI
ACAGCTACAGTAAGAT-1	YRI
ACAGCTAGTAATCGTC-1	CEU
ACAGCTAGTCGCTTTC-1	CEU
ACAGCTAGTTTGCATG-1	YRI
ACAGCTATCAACACTG-1	YRI
ACAGCTATCACCTTAT-1	CEU
ACAGCTATCCCTAACC-1	CEU
ACATACGAGCAGGTCA-1	YRI
ACATACGAGGACACCA-1	YRI
ACATACGAGGTAGCTG-1	CEU
ACATACGAGGTTCCTA-1	CEU
ACATACGAGTAGCGGT-1	CEU
ACATACGAGTGGACGT-1	CEU
ACATACGCACATGGGA-1	YRI
ACATACGGTGCAACGA-1	YRI
ACATACGGTTACGGAG-1	CEU
ACATACGTCCGCAAGC-1	YRI
ACATCAGAGTGTCTCA-1	CEU
ACATCAGCAGACGTAG-1	CEU
ACATCAGCAGGTCTCG-1	YRI
ACATCAGCATAGGATA-1	CEU
ACATCAGGTAGCAAAT-1	YRI
ACATCAGGTTATTCTC-1	YRI
ACATCAGGTTCCTCCA-1	YRI
ACATCAGGTTCGTCTC-1	CEU
ACATCAGTCAATCTCT-1	YRI
ACATCAGTCCCAGGTG-1	YRI
ACATGGTAGACTTTCG-1	CEU
ACATGGTAGCGTTCCG-1	CEU
ACATGGTAGCGTTTAC-1	CEU
ACATGGTAGGTAGCTG-1	CEU
ACATGGTAGTAGGCCA-1	YRI
ACATGGTCAAGTACCT-1	YRI
ACATGGTCAATCCAAC-1	CEU
ACATGGTCAATGACCT-1	YRI
ACATGGTCACTGCCAG-1	CEU
ACATGGTCAGCTGCTG-1	YRI
ACATGGTCATCCCACT-1	YRI
ACATGGTCATGCCTTC-1	CEU
ACATGGTGTAATTGGA-1	CEU
ACATGGTGTATAGGTA-1	YRI
ACATGGTGTCCGTCAG-1	CEU
ACATGGTGTTCATGGT-1	CEU
ACATGGTTCCCATTTA-1	CEU
ACATGGTTCCGCAGTG-1	CEU
ACCAGTAAGATGAGAG-1	CEU
ACCAGTAAGCTAGTTC-1	YRI
ACCAGTAAGGGATACC-1	CEU
ACCAGTAAGTAGATGT-1	CEU
ACCAGTAAGTTCGATC-1	YRI
ACCAGTACAACTGCGC-1	YRI
ACCAGTACATCCTAGA-1	CEU
ACCAGTAGTAGTAGTA-1	CEU
ACCAGTAGTCCGCTGA-1	CEU
ACCAGTAGTGTGTGCC-1	CEU
ACCAGTATCAACGAAA-1	YRI
ACCAGTATCCATGAAC-1	CEU
ACCAGTATCGTACCGG-1	CEU
ACCAGTATCGTGGGAA-1	YRI
ACCCACTAGCCGCCTA-1	YRI
ACCCACTAGTACCGGA-1	YRI
ACCCACTAGTGTTTGC-1	YRI
ACCCACTCAAATCCGT-1	YRI
ACCCACTCACGAAATA-1	YRI
ACCCACTCATGCCTTC-1	YRI
ACCCACTGTGGTAACG-1	CEU
ACCCACTTCAGGCCCA-1	YRI
ACCCACTTCGCCTGAG-1	CEU
ACCGTAAAGAACTGTA-1	YRI
ACCGTAAAGAGGTTGC-1	CEU
ACCGTAAAGCGTGAGT-1	YRI
ACCGTAAAGGGTGTGT-1	YRI
ACCGTAAAGTGTTGAA-1	CEU
ACCGTAACACGCGAAA-1	YRI
ACCGTAACAGATCCAT-1	YRI
ACCGTAACAGCCAGAA-1	YRI
ACCGTAACAGGTTTCA-1	YRI
ACCGTAACATAAAGGT-1	CEU
ACCGTAACATGCTAGT-1	CEU
ACCGTAAGTAGCGATG-1	YRI
ACCGTAAGTCGTGGCT-1	CEU
ACCGTAAGTTCGAATC-1	YRI
ACCGTAAGTTGGACCC-1	YRI
ACCGTAATCAACTCTT-1	YRI
ACCGTAATCAGATAAG-1	CEU
ACCGTAATCTGCCAGG-1	YRI
ACCTTTAAGAGTACAT-1	CEU
ACCTTTAAGCAATATG-1	YRI
ACCTTTAAGCTAACAA-1	YRI
ACCTTTAAGGTGCACA-1	YRI
ACCTTTAAGGTGTTAA-1	CEU
ACCTTTAAGTAAGTAC-1	CEU
ACCTTTAAGTAGGTGC-1	YRI
ACCTTTAAGTGTACTC-1	YRI
ACCTTTACAAACCCAT-1	CEU
ACCTTTACAAGCGCTC-1	CEU
ACCTTTACAAGGTTCT-1	CEU
ACCTTTACACAGCCCA-1	YRI
ACCTTTACATCCAACA-1	YRI
ACCTTTACATCCGTGG-1	CEU
ACCTTTACATGCCTTC-1	CEU
ACCTTTACATTGTGCA-1	YRI
ACCTTTAGTCACCTAA-1	YRI
ACCTTTAGTCTTCGTC-1	CEU
ACCTTTAGTTAGGGTG-1	YRI
ACCTTTATCAACACTG-1	CEU
ACCTTTATCCATGAGT-1	CEU
ACCTTTATCCTCATTA-1	CEU
ACCTTTATCCTTTCTC-1	YRI
ACGAGCCAGAACAACT-1	YRI
ACGAGCCAGAAGGTGA-1	YRI
ACGAGCCAGCCTATGT-1	CEU
ACGAGCCAGGGCTCTC-1	YRI
ACGAGCCAGTACACCT-1	YRI
ACGAGCCCAAACTGTC-1	YRI
ACGAGCCCAGGACGTA-1	CEU
ACGAGCCGTACAGTGG-1	CEU
ACGAGCCGTACCCAAT-1	CEU
ACGAGCCGTATTCTCT-1	YRI
ACGAGCCGTGAGCGAT-1	CEU
ACGAGCCGTGATGTCT-1	YRI
ACGAGCCTCAATCTCT-1	CEU
ACGAGCCTCACAGTAC-1	YRI
ACGAGCCTCCAGAGGA-1	YRI
ACGAGCCTCCATGAGT-1	YRI
ACGAGCCTCCGTTGCT-1	YRI
ACGAGGAAGCGTAATA-1	YRI
ACGAGGAAGGGCACTA-1	YRI
ACGAGGAAGGTAGCCA-1	YRI
ACGAGGACACCATCCT-1	YRI
ACGAGGAGTCGCCATG-1	YRI
ACGAGGAGTCTCCCTA-1	YRI
ACGAGGAGTTACGGAG-1	CEU
ACGAGGATCCCTAATT-1	YRI
ACGAGGATCGCACTCT-1	YRI
ACGAGGATCGGAAACG-1	YRI
ACGAGGATCGGCGCTA-1	YRI
ACGAGGATCTGCCAGG-1	YRI
ACGATACAGAGCCCAA-1	CEU
ACGATACAGCAGATCG-1	YRI
ACGATACAGGAGTACC-1	CEU
ACGATACAGGCCCTCA-1	YRI
ACGATACAGTTGAGAT-1	CEU
ACGATACCAGTAAGCG-1	YRI
ACGATACCATACGCTA-1	YRI
ACGATACGTAAAGTCA-1	CEU
ACGATACGTGTCGCTG-1	CEU
ACGATACTCACCTTAT-1	0
ACGATACTCCATGAAC-1	CEU
ACGATACTCTACTCAT-1	CEU
ACGATACTCTGGTGTA-1	YRI
ACGATGTAGACTTTCG-1	YRI
ACGATGTCACTTGGAT-1	YRI
ACGATGTCAGCGTTCG-1	YRI
ACGATGTCATCTGGTA-1	YRI
ACGATGTGTAAGGATT-1	YRI
ACGATGTGTACTCAAC-1	YRI
ACGATGTGTCATGCAT-1	YRI
ACGATGTGTTACGGAG-1	CEU
ACGATGTGTTGATTGC-1	YRI
ACGATGTTCGGACAAG-1	CEU
ACGATGTTCGGATGGA-1	CEU
ACGCAGCCACATTAGC-1	YRI
ACGCAGCCACCGTTGG-1	YRI
ACGCAGCCACGTTGGC-1	YRI
ACGCAGCGTCCGACGT-1	YRI
ACGCAGCGTCTTCAAG-1	YRI
ACGCAGCGTTAAGTAG-1	YRI
ACGCAGCGTTCGTGAT-1	YRI
ACGCAGCGTTGCGCAC-1	YRI
ACGCAGCTCCGCAAGC-1	YRI
ACGCAGCTCGGAATCT-1	YRI
ACGCCAGCACCTATCC-1	YRI
ACGCCAGCACGAGGTA-1	YRI
ACGCCAGCACTCGACG-1	YRI
ACGCCAGGTACCCAAT-1	CEU
ACGCCAGGTCTCCCTA-1	YRI
ACGCCAGTCAACGGCC-1	YRI
ACGCCGAAGTGTGGCA-1	CEU
ACGCCGACAAAGGCGT-1	YRI
ACGCCGACAACGATGG-1	YRI
ACGCCGACACGGCGTT-1	YRI
ACGCCGAGTAGCTCCG-1	CEU
ACGCCGAGTCACAAGG-1	YRI
ACGCCGAGTCGAATCT-1	YRI
ACGCCGAGTGCCTGTG-1	CEU
ACGCCGATCCAAGCCG-1	CEU
ACGCCGATCGTTTGCC-1	CEU
ACGGAGAAGAACAACT-1	YRI
ACGGAGAAGAACTCGG-1	YRI
ACGGAGAAGAATAGGG-1	YRI
ACGGAGAAGAGAACAG-1	YRI
ACGGAGAAGTGGGCTA-1	YRI
ACGGAGACAGATCGGA-1	YRI
ACGGAGACAGTTAACC-1	YRI
ACGGAGAGTCACCCAG-1	CEU
ACGGAGAGTTACGCGC-1	CEU
ACGGAGATCAAGCCTA-1	CEU
ACGGAGATCACTATTC-1	YRI
ACGGAGATCAGTACGT-1	CEU
ACGGAGATCATGTCTT-1	YRI
ACGGAGATCTGAAAGA-1	YRI
ACGGAGATCTGGCGTG-1	CEU
ACGGCCAAGAGATGAG-1	YRI
ACGGCCAAGCCCAACC-1	CEU
ACGGCCACAAGACACG-1	CEU
ACGGCCACAAGCGAGT-1	YRI
ACGGCCACATTTCACT-1	CEU
ACGGCCAGTCATCGGC-1	YRI
ACGGCCAGTCCGTTAA-1	CEU
ACGGCCAGTGTAACGG-1	YRI
ACGGCCAGTTCCGTCT-1	YRI
ACGGCCATCCAGAGGA-1	YRI
ACGGGCTAGATGGCGT-1	CEU
ACGGGCTAGCGCTTAT-1	YRI
ACGGGCTCAACGATCT-1	CEU
ACGGGCTCAACTGGCC-1	YRI
ACGGGCTCACATGGGA-1	CEU
ACGGGCTCACCCATGG-1	CEU
ACGGGCTGTACCTACA-1	CEU
ACGGGCTGTGCAGACA-1	YRI
ACGGGCTGTGCTAGCC-1	YRI
ACGGGCTTCAGTTTGG-1	CEU
ACGGGCTTCCACTCCA-1	YRI
ACGGGCTTCGTACGGC-1	CEU
ACGGGCTTCTAAGCCA-1	YRI
ACGGGTCAGGCCATAG-1	YRI
ACGGGTCAGTCCATAC-1	CEU
ACGGGTCAGTGTACGG-1	YRI
ACGGGTCAGTGTTAGA-1	YRI
ACGGGTCCAACACCTA-1	CEU
ACGGGTCCAAGCTGAG-1	CEU
ACGGGTCCACATGACT-1	CEU
ACGGGTCCACCAACCG-1	YRI
ACGGGTCCACGGTGTC-1	YRI
ACGGGTCTCGGCGCTA-1	YRI
ACGGGTCTCTAGAGTC-1	CEU
ACGTCAAAGAAGGACA-1	YRI
ACGTCAAAGCAAATCA-1	YRI
ACGTCAAAGGACACCA-1	YRI
ACGTCAAAGTATCTCG-1	YRI
ACGTCAAAGTCGAGTG-1	CEU
ACGTCAAAGTGCGATG-1	CEU
ACGTCAACAATGCCAT-1	YRI
ACGTCAACAGGGCATA-1	YRI
ACGTCAACATAGACTC-1	CEU
ACGTCAAGTACCCAAT-1	YRI
ACGTCAAGTCAGTGGA-1	YRI
ACGTCAAGTCATGCAT-1	YRI
ACGTCAAGTGGAAAGA-1	YRI
ACGTCAAGTTGTTTGG-1	YRI
ACGTCAATCACGAAGG-1	YRI
ACGTCAATCCTTGGTC-1	CEU
ACGTCAATCTCGATGA-1	CEU
ACTATCTAGAGCTATA-1	YRI
ACTATCTAGCTGCGAA-1	CEU
ACTATCTAGGGTTTCT-1	YRI
ACTATCTAGTGTTGAA-1	CEU
ACTATCTGTAAGGATT-1	YRI
ACTATCTGTAGATTAG-1	CEU
ACTATCTGTATTAGCC-1	YRI
ACTATCTGTCTGCCAG-1	YRI
ACTATCTGTGAGTGAC-1	CEU
ACTATCTTCAAACCGT-1	YRI
ACTATCTTCACCTTAT-1	YRI
ACTATCTTCGGTTCGG-1	CEU
ACTGAACAGCACGCCT-1	CEU
ACTGAACAGCGATAGC-1	YRI
ACTGAACAGGGATGGG-1	YRI
ACTGAACAGGTGTTAA-1	YRI
ACTGAACAGTCAAGGC-1	CEU
ACTGAACGTAAACCTC-1	YRI
ACTGAACGTAGAGTGC-1	YRI
ACTGAACGTTCCCGAG-1	CEU
ACTGAACGTTCGTTGA-1	CEU
ACTGAACTCAGTTGAC-1	YRI
ACTGAACTCATCGCTC-1	YRI
ACTGAACTCCGCGCAA-1	CEU
ACTGAACTCCTCGCAT-1	CEU
ACTGAACTCGGCCGAT-1	YRI
ACTGAACTCTGGTATG-1	YRI
ACTGAACTCTTGAGGT-1	YRI
ACTGAGTAGGACGAAA-1	YRI
ACTGAGTAGGTAGCCA-1	YRI
ACTGAGTAGTCGAGTG-1	YRI
ACTGAGTAGTTAACGA-1	YRI
ACTGAGTCAGAGTGTG-1	YRI
ACTGAGTCAGGTGCCT-1	CEU
ACTGAGTCATGGTCAT-1	YRI
ACTGAGTTCAAAGACA-1	CEU
ACTGAGTTCAGTTTGG-1	CEU
ACTGAGTTCATAAAGG-1	CEU
ACTGAGTTCATCGCTC-1	CEU
ACTGAGTTCATTGCCC-1	CEU
ACTGAGTTCCAAAGTC-1	YRI
ACTGAGTTCTGGTGTA-1	YRI
ACTGAGTTCTGTCAAG-1	CEU
ACTGATGAGAACAACT-1	YRI
ACTGATGAGAGCTTCT-1	CEU
ACTGATGAGTCAAGGC-1	YRI
ACTGATGAGTTAGCGG-1	CEU
ACTGATGAGTTGAGTA-1	YRI
ACTGATGGTAACGTTC-1	YRI
ACTGATGGTAGCGATG-1	CEU
ACTGATGGTATGGTTC-1	YRI
ACTGATGTCACCCTCA-1	YRI
ACTGATGTCCAGGGCT-1	YRI
ACTGATGTCCATGAAC-1	CEU
ACTGATGTCCTTGACC-1	YRI
ACTGATGTCGGCGGTT-1	YRI
ACTGATGTCTCCTATA-1	CEU
ACTGATGTCTGAAAGA-1	CEU
ACTGCTCAGAAGGACA-1	YRI
ACTGCTCAGTATCTCG-1	YRI
ACTGCTCAGTGGTAAT-1	YRI
ACTGCTCCATCGGTTA-1	YRI
ACTGCTCGTTGGTAAA-1	YRI
ACTGCTCTCGATGAGG-1	YRI
ACTGCTCTCTAACGGT-1	YRI
ACTGTCCAGATATGGT-1	CEU
ACTGTCCAGTGCGATG-1	CEU
ACTGTCCAGTTCGCAT-1	YRI
ACTGTCCCACCGCTAG-1	CEU
ACTGTCCCACCGGAAA-1	YRI
ACTGTCCCAGTTAACC-1	YRI
ACTGTCCCATGACATC-1	CEU
ACTGTCCGTTCACGGC-1	CEU
ACTGTCCTCAAAGACA-1	YRI
ACTGTCCTCCCTCAGT-1	YRI
ACTGTCCTCTCTAGGA-1	CEU
ACTTACTAGAGCAATT-1	YRI
ACTTACTAGATGCCAG-1	CEU
ACTTACTAGTCAATAG-1	YRI
ACTTACTCAAGGTTCT-1	YRI
ACTTACTCACATGGGA-1	CEU
ACTTACTCAGCTGCTG-1	YRI
ACTTACTCATCCAACA-1	YRI
ACTTACTGTACAGACG-1	CEU
ACTTACTGTCGCGTGT-1	YRI
ACTTACTGTCTGATCA-1	CEU
ACTTACTGTTGCGTTA-1	YRI
ACTTACTTCAGCTTAG-1	YRI
ACTTACTTCCTGCAGG-1	YRI
ACTTACTTCGTGGTCG-1	CEU
ACTTACTTCGTTTAGG-1	CEU
ACTTGTTAGAAACCGC-1	YRI
ACTTGTTAGAAGGACA-1	YRI
ACTTGTTAGCCCGAAA-1	CEU
ACTTGTTCAGCAGTTT-1	YRI
ACTTGTTCATAAAGGT-1	YRI
ACTTGTTCATGCTAGT-1	CEU
ACTTGTTGTTATGCGT-1	YRI
ACTTGTTGTTCATGGT-1	YRI
ACTTGTTTCACTTACT-1	YRI
ACTTGTTTCCAAACTG-1	CEU
ACTTGTTTCCCTCAGT-1	CEU
ACTTGTTTCTGGTGTA-1	YRI
ACTTGTTTCTTGACGA-1	YRI
ACTTTCAAGACTTTCG-1	CEU
ACTTTCAAGGACCACA-1	CEU
ACTTTCAAGGAGTAGA-1	YRI
ACTTTCAAGGTAGCCA-1	YRI
ACTTTCACAAAGCGGT-1	CEU
ACTTTCACACAGACTT-1	CEU
ACTTTCAGTATTCTCT-1	YRI
ACTTTCAGTTTGTGTG-1	CEU
ACTTTCATCACCGGGT-1	CEU
ACTTTCATCAGGATCT-1	YRI
ACTTTCATCCGCAGTG-1	YRI
ACTTTCATCCTTAATC-1	YRI
ACTTTCATCGGGAGTA-1	YRI
ACTTTCATCTTTAGGG-1	YRI
AGAATAGAGCTAGGCA-1	CEU
AGAATAGAGGCTATCT-1	YRI
AGAATAGAGTGTCTCA-1	YRI
AGAATAGCAGGTCGTC-1	CEU
AGAATAGGTCAGTGGA-1	YRI
AGAATAGGTCCTCCAT-1	YRI
AGAATAGGTCTAGTGT-1	YRI
AGAATAGGTGATAAGT-1	YRI
AGAATAGGTGGTTTCA-1	YRI
AGAATAGTCCAAAGTC-1	YRI
AGACGTTAGCTCCTCT-1	CEU
AGACGTTAGGCAAAGA-1	YRI
AGACGTTAGGCTCAGA-1	YRI
AGACGTTAGGGTGTTG-1	YRI
AGACGTTAGTACATGA-1	YRI
AGACGTTCAGGGATTG-1	CEU
AGACGTTCATAAAGGT-1	YRI
AGACGTTGTCATTAGC-1	CEU
AGACGTTGTGCCTGTG-1	YRI
AGACGTTGTTCAGTAC-1	YRI
AGACGTTTCACGGTTA-1	YRI
AGAGCGAAGATAGCAT-1	YRI
AGAGCGAAGATATACG-1	YRI
AGAGCGAAGCTGCGAA-1	CEU
AGAGCGAAGTCATCCA-1	YRI
AGAGCGACAAACGCGA-1	YRI
AGAGCGACACATGACT-1	YRI
AGAGCGACAGATCCAT-1	YRI
AGAGCGACAGGACGTA-1	CEU
AGAGCGACATAGGATA-1	YRI
AGAGCGACATGAGCGA-1	CEU
AGAGCGACATTGGTAC-1	YRI
AGAGCGAGTGTAATGA-1	YRI
AGAGCGAGTTCCATGA-1	CEU
AGAGCGATCCCTAACC-1	CEU
AGAGCGATCGTAGGTT-1	CEU
AGAGCGATCTCTTGAT-1	YRI
AGAGCGATCTTTAGTC-1	YRI
AGAGCTTAGACAGAGA-1	YRI
AGAGCTTAGACTAGGC-1	YRI
AGAGCTTAGCAGGCTA-1	YRI
AGAGCTTAGCCGCCTA-1	YRI
AGAGCTTAGTCACGCC-1	CEU
AGAGCTTCAAATCCGT-1	YRI
AGAGCTTCAATGGACG-1	YRI
AGAGCTTCACTATCTT-1	YRI
AGAGCTTCACTGTGTA-1	YRI
AGAGCTTGTTACCGAT-1	CEU
AGAGCTTGTTCCTCCA-1	CEU
AGAGCTTGTTTAGGAA-1	CEU
AGAGCTTGTTTGACTG-1	CEU
AGAGCTTTCAGTTCGA-1	YRI
AGAGCTTTCGCTTAGA-1	YRI
AGAGCTTTCGGTGTCG-1	CEU
AGAGCTTTCGTCGTTC-1	CEU
AGAGTGGAGCTGAAAT-1	CEU
AGAGTGGAGGCTATCT-1	YRI
AGAGTGGAGTTCCACA-1	CEU
AGAGTGGGTAGCCTCG-1	YRI
AGAGTGGGTGTGACCC-1	CEU
AGAGTGGGTTGGTGGA-1	YRI
AGAGTGGTCACTATTC-1	YRI
AGAGTGGTCAGCAACT-1	CEU
AGAGTGGTCAGTTTGG-1	YRI
AGAGTGGTCATAGCAC-1	YRI
AGAGTGGTCCAGAGGA-1	CEU
AGATCTGAGCGTGAAC-1	CEU
AGATCTGCAAAGCGGT-1	YRI
AGATCTGCACAAGACG-1	YRI
AGATCTGCACCGCTAG-1	CEU
AGATCTGCAGGGCATA-1	CEU
AGATCTGGTATAGGTA-1	YRI
AGATCTGGTGTCAATC-1	YRI
AGATCTGGTTAGATGA-1	YRI
AGATCTGTCATTCACT-1	CEU
AGATCTGTCCGAATGT-1	CEU
AGATCTGTCCTATGTT-1	YRI
AGATCTGTCGAATGGG-1	CEU
AGATCTGTCTGGTTCC-1	CEU
AGATTGCAGTAGCGGT-1	YRI
AGATTGCAGTGAAGAG-1	CEU
AGATTGCAGTGCGTGA-1	YRI
AGATTGCAGTTTCCTT-1	YRI
AGATTGCCAAGGCTCC-1	YRI
AGATTGCCAATCGGTT-1	CEU
AGATTGCCAATGAAAC-1	CEU
AGATTGCCACCAGGTC-1	CEU
AGATTGCCAGTTCCCT-1	CEU
AGATTGCGTACCGAGA-1	YRI
AGATTGCGTACCGTTA-1	YRI
AGATTGCGTCACTGGC-1	YRI
AGATTGCGTCGAGTTT-1	YRI
AGATTGCGTGAGGGAG-1	YRI
AGATTGCGTTATGTGC-1	YRI
AGATTGCTCAACACCA-1	YRI
AGATTGCTCGGTCCGA-1	YRI
AGATTGCTCTGCGTAA-1	YRI
AGCAGCCAGATGTCGG-1	CEU
AGCAGCCAGATTACCC-1	YRI
AGCAGCCAGCTCCTCT-1	YRI
AGCAGCCCAAGCCCAC-1	CEU
AGCAGCCCAAGGTGTG-1	YRI
AGCAGCCCAATGGAGC-1	YRI
AGCAGCCGTCGAAAGC-1	YRI
AGCAGCCGTTGCCTCT-1	YRI
AGCAGCCGTTGGAGGT-1	YRI
AGCAGCCTCACGACTA-1	YRI
AGCATACAGCAGACTG-1	CEU
AGCATACAGTGCCATT-1	YRI
AGCATACAGTTCGATC-1	YRI
AGCATACCAAGGTTTC-1	YRI
AGCATACCAATCCGAT-1	YRI
AGCATACCACAGTCGC-1	YRI
AGCATACCACGAAACG-1	YRI
AGCATACCAGCTGTTA-1	YRI
AGCATACCATATGAGA-1	YRI
AGCATACCATTTGCTT-1	YRI
AGCATACGTCCGTGAC-1	YRI
AGCATACGTTCAGACT-1	CEU
AGCATACTCCCAACGG-1	YRI
AGCATACTCCCGGATG-1	YRI
AGCCTAAAGCGTTTAC-1	YRI
AGCCTAAAGGAATTAC-1	YRI
AGCCTAAAGGGCTTGA-1	CEU
AGCCTAACAATGGATA-1	YRI
AGCCTAACACAACGTT-1	CEU
AGCCTAACATAGACTC-1	YRI
AGCCTAACATGATCCA-1	YRI
AGCCTAACATTCGACA-1	YRI
AGCCTAAGTAACGACG-1	YRI
AGCCTAAGTCTTTCAT-1	YRI
AGCCTAAGTGAGGCTA-1	CEU
AGCCTAAGTGCGCTTG-1	YRI
AGCCTAAGTGTGCGTC-1	CEU
AGCCTAATCGTAGATC-1	CEU
AGCGGTCCAGCTCGCA-1	CEU
AGCGGTCCATACCATG-1	CEU
AGCGGTCCATCTATGG-1	CEU
AGCGGTCCATGACGGA-1	YRI
AGCGGTCGTAACGTTC-1	YRI
AGCGGTCGTAGCGTAG-1	YRI
AGCGGTCGTCGAACAG-1	YRI
AGCGGTCGTCGCCATG-1	YRI
AGCGGTCGTTACCGAT-1	YRI
AGCGTATAGAGTCTGG-1	YRI
AGCGTATAGGAGTCTG-1	YRI
AGCGTATCACCGTTGG-1	CEU
AGCGTATGTCTAAACC-1	YRI
AGCGTATGTTCGAATC-1	CEU
AGCGTATGTTGCTCCT-1	YRI
AGCGTATTCCTCCTAG-1	YRI
AGCGTATTCGGCTACG-1	YRI
AGCGTATTCTAGCACA-1	YRI
AGCGTCGAGCTAGCCC-1	YRI
AGCGTCGCAAGGGTCA-1	CEU
AGCGTCGCACAGATTC-1	YRI
AGCGTCGGTAGCCTAT-1	YRI
AGCGTCGGTGCAGTAG-1	YRI
AGCGTCGGTTTGACTG-1	CEU
AGCGTCGTCACGAAGG-1	CEU
AGCGTCGTCCACGAAT-1	YRI
AGCGTCGTCCGTTGCT-1	CEU
AGCTCCTAGGAGTACC-1	YRI
AGCTCCTAGGTGACCA-1	CEU
AGCTCCTCACAGAGGT-1	CEU
AGCTCCTCACCAGGCT-1	YRI
AGCTCCTCATATGGTC-1	YRI
AGCTCCTGTCAGAATA-1	YRI
AGCTCCTGTTCCGTCT-1	YRI
AGCTCCTGTTCCTCCA-1	CEU
AGCTCCTGTTGGAGGT-1	CEU
AGCTCCTTCAGCTTAG-1	CEU
AGCTCCTTCAGGCCCA-1	YRI
AGCTCCTTCATGTGGT-1	YRI
AGCTCCTTCGCAAACT-1	CEU
AGCTCTCAGCCTATGT-1	YRI
AGCTCTCCAAGCCCAC-1	CEU
AGCTCTCCATAACCTG-1	CEU
AGCTCTCGTCTCGTTC-1	YRI
AGCTCTCTCAAACAAG-1	YRI
AGCTCTCTCACCAGGC-1	YRI
AGCTCTCTCATGCAAC-1	CEU
AGCTCTCTCATGTCTT-1	CEU
AGCTCTCTCCCAAGTA-1	YRI
AGCTCTCTCCTCATTA-1	CEU
AGCTCTCTCTCTAAGG-1	YRI
AGCTTGAAGAAGGCCT-1	YRI
AGCTTGAAGGTCATCT-1	CEU
AGCTTGACAAGAAGAG-1	YRI
AGCTTGACAGCTCGAC-1	YRI
AGCTTGACATTTCAGG-1	YRI
AGCTTGAGTACCGTAT-1	YRI
AGCTTGAGTGCAGGTA-1	YRI
AGCTTGATCAAAGTAG-1	CEU
AGCTTGATCCTTCAAT-1	CEU
AGCTTGATCTACGAGT-1	CEU
AGCTTGATCTATGTGG-1	CEU
AGCTTGATCTGTCTCG-1	CEU
AGGCCACAGAAACCGC-1	YRI
AGGCCACAGAGATGAG-1	YRI
AGGCCACAGTAGATGT-1	CEU
AGGCCACCACACCGAC-1	YRI
AGGCCACCACATCCGG-1	CEU
AGGCCACCACCCAGTG-1	CEU
AGGCCACCAGGAACGT-1	YRI
AGGCCACCAGGACGTA-1	CEU
AGGCCACCAGGCTGAA-1	YRI
AGGCCACCATCGGGTC-1	CEU
AGGCCACCATCTATGG-1	CEU
AGGCCACGTTAGGGTG-1	CEU
AGGCCACGTTTGTTGG-1	CEU
AGGCCACTCCAGAAGG-1	YRI
AGGCCACTCGGCGGTT-1	YRI
AGGCCACTCGTCCAGG-1	CEU
AGGCCACTCTATCCCG-1	CEU
AGGCCACTCTGGTTCC-1	YRI
AGGCCACTCTGTTGAG-1	CEU
AGGCCGTAGATCTGCT-1	CEU
AGGCCGTAGCAATCTC-1	YRI
AGGCCGTGTCCAACTA-1	YRI
AGGCCGTGTTCGTTGA-1	CEU
AGGCCGTTCACCAGGC-1	YRI
AGGCCGTTCAGAGGTG-1	CEU
AGGCCGTTCTAACTCT-1	CEU
AGGGAGTAGAGCTGGT-1	YRI
AGGGAGTAGCAATCTC-1	YRI
AGGGAGTAGGATGTAT-1	YRI
AGGGAGTCACACCGCA-1	CEU
AGGGAGTCACATTAGC-1	CEU
AGGGAGTGTCGTCTTC-1	YRI
AGGGAGTGTTCATGGT-1	CEU
AGGGAGTGTTTGTTGG-1	CEU
AGGGAGTTCCCTGACT-1	CEU
AGGGAGTTCTGTTTGT-1	YRI
AGGGAGTTCTTGGGTA-1	CEU
AGGGATGAGAAACCGC-1	YRI
AGGGATGAGCCGATTT-1	CEU
AGGGATGCACTTAAGC-1	CEU
AGGGATGCATATACGC-1	CEU
AGGGATGCATCAGTAC-1	YRI
AGGGATGGTCGATTGT-1	YRI
AGGGATGTCTGATTCT-1	YRI
AGGGATGTCTGCGGCA-1	YRI
AGGGTGACAATAACGA-1	YRI
AGGGTGACACGCCAGT-1	YRI
AGGGTGACACGTCTCT-1	CEU
AGGGTGAGTGCACGAA-1	YRI
AGGGTGAGTGCTAGCC-1	CEU
AGGGTGATCCGATATG-1	CEU
AGGGTGATCCGTAGTA-1	YRI
AGGGTGATCGATAGAA-1	CEU
AGGTCATAGAAACCGC-1	YRI
AGGTCATAGAATTGTG-1	YRI
AGGTCATAGTGCGTGA-1	YRI
AGGTCATCAAGCTGAG-1	YRI
AGGTCATCACACGCTG-1	YRI
AGGTCATCACCCAGTG-1	YRI
AGGTCATCAGTATAAG-1	YRI
AGGTCATCATTCTTAC-1	CEU
AGGTCATGTAAGGGAA-1	YRI
AGGTCATGTCCAAGTT-1	YRI
AGGTCATGTGTCGCTG-1	YRI
AGGTCATGTGTTTGTG-1	YRI
AGGTCATTCACTATTC-1	YRI
AGGTCATTCATCGGAT-1	YRI
AGGTCATTCCAGAGGA-1	YRI
AGGTCATTCCATGAGT-1	CEU
AGGTCATTCGGTTAAC-1	YRI
AGGTCATTCTCACATT-1	YRI
AGGTCATTCTGCGTAA-1	YRI
AGGTCCGAGTACGATA-1	CEU
AGGTCCGCAATGAATG-1	YRI
AGGTCCGCACCTCGTT-1	YRI
AGGTCCGCATATGGTC-1	YRI
AGGTCCGGTGTGAATA-1	YRI
AGGTCCGGTGTGCGTC-1	CEU
AGGTCCGTCAACACCA-1	YRI
AGGTCCGTCCACGTTC-1	CEU
AGGTCCGTCTACTCAT-1	YRI
AGGTCCGTCTGCGACG-1	YRI
AGGTCCGTCTGGTTCC-1	CEU
AGTAGTCAGACTCGGA-1	CEU
AGTAGTCAGAGGACGG-1	YRI
AGTAGTCCAATCCAAC-1	YRI
AGTAGTCGTGAGTATA-1	CEU
AGTAGTCGTTATCCGA-1	YRI
AGTAGTCTCGCGGATC-1	CEU
AGTAGTCTCTAACTGG-1	CEU
AGTCTTTAGAAGATTC-1	CEU
AGTCTTTAGCGCTCCA-1	YRI
AGTCTTTAGTGTTGAA-1	YRI
AGTCTTTCAGTGGGAT-1	YRI
AGTCTTTCATCTATGG-1	YRI
AGTCTTTGTCAAAGAT-1	YRI
AGTCTTTGTGCAGTAG-1	YRI
AGTCTTTGTGCTAGCC-1	CEU
AGTCTTTTCACCTCGT-1	YRI
AGTCTTTTCACTGGGC-1	CEU
AGTCTTTTCCATGAAC-1	YRI
AGTCTTTTCGTTTATC-1	YRI
AGTCTTTTCTAACCGA-1	YRI
AGTGAGGCAAACGTGG-1	YRI
AGTGAGGGTCCGAAGA-1	CEU
AGTGAGGTCAAGCCTA-1	YRI
AGTGAGGTCATCTGTT-1	YRI
AGTGGGAAGAGTCGGT-1	YRI
AGTGGGAAGGACATTA-1	YRI
AGTGGGACACGGCTAC-1	YRI
AGTGGGACAGTCACTA-1	CEU
AGTGGGACATTAACCG-1	CEU
AGTGGGAGTAGGGTAC-1	YRI
AGTGGGAGTGCAACTT-1	YRI
AGTGGGAGTGCCTGGT-1	YRI
AGTGGGAGTGGTCCGT-1	CEU
AGTGGGATCCTCATTA-1	CEU
AGTGGGATCGCCTGTT-1	CEU
AGTGGGATCGGTCCGA-1	YRI
AGTGGGATCTCTAGGA-1	YRI
AGTGTCAAGAGCTGGT-1	CEU
AGTGTCAAGCAGCCTC-1	CEU
AGTGTCAAGCTTATCG-1	YRI
AGTGTCACACCCATGG-1	CEU
AGTGTCAGTAGGCATG-1	CEU
AGTGTCAGTCTCGTTC-1	YRI
AGTGTCAGTTCCGTCT-1	YRI
AGTGTCAGTTCGGGCT-1	YRI
AGTGTCATCTATCGCC-1	YRI
AGTTGGTAGGCACATG-1	CEU
AGTTGGTCAACACCTA-1	CEU
AGTTGGTCACCTGGTG-1	YRI
AGTTGGTCACTGTTAG-1	YRI
AGTTGGTCAGCCTGTG-1	YRI
AGTTGGTCAGGTCGTC-1	YRI
AGTTGGTCATCACCCT-1	YRI
AGTTGGTGTCTCTTAT-1	CEU
AGTTGGTGTGCACGAA-1	YRI
AGTTGGTTCAGAGGTG-1	YRI
AGTTGGTTCGGCGCAT-1	YRI
AGTTGGTTCTATCCCG-1	YRI
AGTTGGTTCTTACCGC-1	YRI
ATAACGCAGATGCCAG-1	YRI
ATAACGCAGCGACGTA-1	YRI
ATAACGCAGTTTAGGA-1	CEU
ATAACGCCACGTCTCT-1	YRI
ATAACGCCAGAAGCAC-1	CEU
ATAACGCCATCACGAT-1	CEU
ATAACGCCATGCCACG-1	CEU
ATAACGCGTTCTGTTT-1	YRI
ATAACGCGTTGTACAC-1	YRI
ATAACGCTCAGCTGGC-1	CEU
ATAACGCTCCCTCTTT-1	CEU
ATAACGCTCGGTCTAA-1	YRI
ATAACGCTCTGCGGCA-1	YRI
ATAAGAGAGGCTAGCA-1	CEU
ATAAGAGAGTAGGTGC-1	YRI
ATAAGAGAGTGAAGTT-1	YRI
ATAAGAGCACGTCAGC-1	CEU
ATAAGAGCAGCTCCGA-1	YRI
ATAAGAGCAGGTGGAT-1	YRI
ATAAGAGCATTGGGCC-1	CEU
ATAAGAGGTAATAGCA-1	YRI
ATAAGAGGTCCAACTA-1	YRI
ATAAGAGGTCTCACCT-1	YRI
ATAAGAGGTGGCCCTA-1	YRI
ATAAGAGGTTCTGAAC-1	YRI
ATAAGAGTCATCATTC-1	CEU
ATAAGAGTCATGCATG-1	YRI
ATAAGAGTCGGATGTT-1	CEU
ATAAGAGTCGGTCTAA-1	CEU
ATAGACCAGAGCTGGT-1	YRI
ATAGACCAGAGGTACC-1	YRI
ATAGACCAGCTACCTA-1	CEU
ATAGACCAGTTAGCGG-1	YRI
ATAGACCCAAACCTAC-1	CEU
ATAGACCCAAGGGTCA-1	YRI
ATAGACCCAATGTAAG-1	CEU
ATAGACCCAGCGATCC-1	CEU
ATAGACCCAGGGTTAG-1	CEU
ATAGACCCAGTGGAGT-1	CEU
ATAGACCCATCGGGTC-1	CEU
ATAGACCGTGCAACTT-1	YRI
ATAGACCTCCCACTTG-1	CEU
ATAGACCTCCCGGATG-1	YRI
ATAGACCTCGCCTGTT-1	YRI
ATAGACCTCGGCATCG-1	YRI
ATAGACCTCGTTGACA-1	YRI
ATAGACCTCTGCGACG-1	YRI
ATCACGACACCAGATT-1	CEU
ATCACGACATGCATGT-1	YRI
ATCACGAGTATCGCAT-1	YRI
ATCACGAGTCTTGCGG-1	CEU
ATCACGAGTGTGCCTG-1	YRI
ATCACGAGTTACTGAC-1	CEU
ATCACGAGTTATGCGT-1	YRI
ATCACGATCAAGGCTT-1	YRI
ATCACGATCCTCCTAG-1	YRI
ATCACGATCTGATTCT-1	CEU
ATCATCTAGGCAGGTT-1	YRI
ATCATCTAGTCTCAAC-1	CEU
ATCATCTAGTTTGCGT-1	YRI
ATCATCTCACCCTATC-1	CEU
ATCATCTCAGGTCGTC-1	CEU
ATCATCTGTAAACGCG-1	YRI
ATCATCTGTGGCTCCA-1	YRI
ATCATGGAGCCGCCTA-1	CEU
ATCATGGAGTGAAGAG-1	CEU
ATCATGGCAGCTGGCT-1	YRI
ATCATGGCAGGAATGC-1	YRI
ATCATGGGTAAATACG-1	CEU
ATCATGGGTATATGGA-1	YRI
ATCCACCAGAATGTTG-1	YRI
ATCCACCAGACAATAC-1	YRI
ATCCACCAGGGTCTCC-1	YRI
ATCCACCAGTCAATAG-1	YRI
ATCCACCAGTCGCCGT-1	YRI
ATCCACCAGTGACTCT-1	YRI
ATCCACCCAAGAGGCT-1	CEU
ATCCACCCAATAGCAA-1	CEU
ATCCACCCACAAGACG-1	YRI
ATCCACCCACTCTGTC-1	CEU
ATCCACCCATCTCGCT-1	YRI
ATCCACCCATGTTCCC-1	YRI
ATCCACCGTCGCGGTT-1	YRI
ATCCACCGTGTTTGGT-1	YRI
ATCCACCGTTCAGTAC-1	YRI
ATCCACCTCACATAGC-1	YRI
ATCCACCTCACTTATC-1	YRI
ATCCACCTCCATGAAC-1	YRI
ATCCGAAAGATGAGAG-1	CEU
ATCCGAAAGGTGCAAC-1	CEU
ATCCGAAAGTCCGTAT-1	YRI
ATCCGAACACAGAGGT-1	CEU
ATCCGAAGTACAGCAG-1	CEU
ATCCGAAGTCTGGAGA-1	CEU
ATCCGAATCACCGGGT-1	YRI
ATCCGAATCCGGGTGT-1	CEU
ATCCGAATCCTAGGGC-1	YRI
ATCCGAATCTGTCTCG-1	YRI
ATCGAGTAGGACTGGT-1	CEU
ATCGAGTAGTGTACTC-1	CEU
ATCGAGTCAACGATCT-1	CEU
ATCGAGTCAACGATGG-1	CEU
ATCGAGTCATCATCCC-1	CEU
ATCGAGTCATGTTGAC-1	CEU
ATCGAGTGTAGCGCTC-1	YRI
ATCGAGTGTCACTTCC-1	YRI
ATCGAGTGTCCGTCAG-1	YRI
ATCGAGTGTGGCTCCA-1	CEU
ATCGAGTGTTATGTGC-1	CEU
ATCGAGTGTTTGTTGG-1	YRI
ATCGAGTTCCACTCCA-1	YRI
ATCGAGTTCCATTCTA-1	YRI
ATCGAGTTCCCTTGCA-1	YRI
ATCTACTAGAACAATC-1	CEU
ATCTACTAGCTGATAA-1	YRI
ATCTACTCAAGCTGTT-1	YRI
ATCTACTCACAGAGGT-1	YRI
ATCTACTCACCTTGTC-1	CEU
ATCTACTGTAGCACGA-1	CEU
ATCTACTGTCTAGTGT-1	CEU
ATCTACTGTCTCTTTA-1	CEU
ATCTACTGTGCCTGGT-1	YRI
ATCTACTGTGGCGAAT-1	YRI
ATCTACTGTTTGGCGC-1	YRI
ATCTACTTCCGAGCCA-1	YRI
ATCTACTTCCTTCAAT-1	CEU
ATCTACTTCTAACCGA-1	YRI
ATCTGCCAGACAGACC-1	YRI
ATCTGCCAGAGGTACC-1	CEU
ATCTGCCAGGTCATCT-1	YRI
ATCTGCCCAGCTGGCT-1	CEU
ATCTGCCGTAGCAAAT-1	YRI
ATCTGCCGTTGTTTGG-1	YRI
ATCTGCCTCACCCGAG-1	YRI
ATCTGCCTCAGCCTAA-1	CEU
ATCTGCCTCCATTCTA-1	YRI
ATCTGCCTCGCATGAT-1	YRI
ATCTGCCTCTGGTGTA-1	YRI
ATGAGGGAGGACCACA-1	YRI
ATGAGGGAGTCATCCA-1	CEU
ATGAGGGCAAGAGTCG-1	YRI
ATGAGGGCAATGTTGC-1	YRI
ATGAGGGCACTTGGAT-1	YRI
ATGAGGGCAGCCTTGG-1	CEU
ATGAGGGCATTCCTCG-1	CEU
ATGAGGGGTCACTGGC-1	CEU
ATGAGGGTCACGATGT-1	CEU
ATGAGGGTCCGTCATC-1	YRI
ATGAGGGTCTTAACCT-1	CEU
ATGAGGGTCTTTACAC-1	YRI
ATGCGATAGGAATCGC-1	YRI
ATGCGATAGTGGACGT-1	YRI
ATGCGATCAAACCCAT-1	YRI
ATGCGATCAGTATCTG-1	YRI
ATGCGATGTACCGTTA-1	YRI
ATGCGATGTGTGCCTG-1	YRI
ATGCGATTCCCTGACT-1	YRI
ATGCGATTCTAACTTC-1	CEU
ATGGGAGAGAATCTCC-1	CEU
ATGGGAGCAAGTTGTC-1	CEU
ATGGGAGCACAGTCGC-1	CEU
ATGGGAGCACCCAGTG-1	CEU
ATGGGAGCATGCTAGT-1	YRI
ATGGGAGGTAGGGTAC-1	CEU
ATGGGAGGTCTCAACA-1	YRI
ATGGGAGGTCTGCCAG-1	YRI
ATGGGAGTCACAAACC-1	YRI
ATGGGAGTCACCAGGC-1	CEU
ATGGGAGTCACTCTTA-1	CEU
ATGGGAGTCGACCAGC-1	YRI
ATGGGAGTCGTCTGAA-1	CEU
ATGGGAGTCGTTGACA-1	CEU
ATGGGAGTCTGCTGCT-1	YRI
ATGTGTGAGATGTTAG-1	YRI
ATGTGTGAGGGCATGT-1	YRI
ATGTGTGAGGGCTTGA-1	YRI
ATGTGTGAGGTGATTA-1	CEU
ATGTGTGCAAGCGCTC-1	CEU
ATGTGTGCACCAGGCT-1	YRI
ATGTGTGCACCATGTA-1	YRI
ATGTGTGCACTCGACG-1	YRI
ATGTGTGGTACAGACG-1	YRI
ATGTGTGGTCGAACAG-1	CEU
ATGTGTGGTGAACCTT-1	CEU
ATTACTCAGATGTAAC-1	CEU
ATTACTCAGTCACGCC-1	CEU
ATTACTCAGTCATGCT-1	YRI
ATTACTCCAGGTCTCG-1	YRI
ATTACTCCATCGATTG-1	CEU
ATTACTCGTCCGAACC-1	CEU
ATTACTCGTCCGAAGA-1	YRI
ATTACTCGTGCAACGA-1	CEU
ATTACTCTCCTTCAAT-1	CEU
ATTACTCTCTTTAGTC-1	CEU
ATTATCCAGGACACCA-1	YRI
ATTATCCAGTAGCCGA-1	YRI
ATTATCCCAAGAAAGG-1	YRI
ATTATCCCAAGGACTG-1	YRI
ATTATCCCACACCGAC-1	YRI
ATTATCCCACAGGAGT-1	CEU
ATTATCCCATTGAGCT-1	CEU
ATTATCCGTATAGGGC-1	YRI
ATTATCCGTCCAAGTT-1	YRI
ATTATCCTCCATTCTA-1	CEU
ATTCTACAGAGATGAG-1	YRI
ATTCTACAGCTAACTC-1	YRI
ATTCTACAGCTTTGGT-1	YRI
ATTCTACAGGCTCATT-1	YRI
ATTCTACCAGGCTCAC-1	YRI
ATTCTACCATTCTCAT-1	YRI
ATTCTACGTATTAGCC-1	YRI
ATTCTACGTCAAACTC-1	YRI
ATTCTACGTCTCGTTC-1	CEU
ATTCTACGTGACGCCT-1	YRI
ATTCTACGTGCAGTAG-1	YRI
ATTCTACTCACTTATC-1	CEU
ATTGGACAGAACTCGG-1	YRI
ATTGGACAGAATTGTG-1	YRI
ATTGGACAGGTTCCTA-1	CEU
ATTGGACAGTTATCGC-1	CEU
ATTGGACCACTTCTGC-1	CEU
ATTGGACCATACTACG-1	YRI
ATTGGACCATGGGACA-1	YRI
ATTGGACGTATCGCAT-1	YRI
ATTGGACGTGACTCAT-1	YRI
ATTGGACGTGCACCAC-1	YRI
ATTGGACTCAGCATGT-1	CEU
ATTGGACTCCAACCAA-1	YRI
ATTGGACTCTCCTATA-1	CEU
ATTGGACTCTGCAAGT-1	YRI
ATTGGTGAGAAGGACA-1	YRI
ATTGGTGAGCAATCTC-1	YRI
ATTGGTGAGCGCCTCA-1	YRI
ATTGGTGAGCGTGAGT-1	YRI
ATTGGTGAGGCCCGTT-1	YRI
ATTGGTGAGGGAGTAA-1	CEU
ATTGGTGAGTCCCACG-1	YRI
ATTGGTGCATCTCCCA-1	YRI
ATTGGTGGTCTCTCGT-1	YRI
ATTGGTGGTTGATTCG-1	CEU
ATTGGTGTCCAGTAGT-1	CEU
ATTGGTGTCCCATTTA-1	YRI
ATTGGTGTCCCTTGTG-1	CEU
ATTGGTGTCGCTTAGA-1	YRI
ATTGGTGTCGTTTAGG-1	CEU
ATTGGTGTCTGCCAGG-1	YRI
ATTTCTGAGAAGGTGA-1	CEU
ATTTCTGAGAGCTTCT-1	YRI
ATTTCTGAGCCAGTTT-1	YRI
ATTTCTGAGTGTACCT-1	CEU
ATTTCTGCAAATACAG-1	YRI
ATTTCTGCAATCACAC-1	YRI
ATTTCTGCACACTGCG-1	YRI
ATTTCTGGTCAGTGGA-1	CEU
ATTTCTGGTCATACTG-1	YRI
ATTTCTGGTGCCTTGG-1	YRI
ATTTCTGGTGTCAATC-1	YRI
ATTTCTGGTTCCACAA-1	YRI
ATTTCTGTCAGCAACT-1	CEU
ATTTCTGTCAGCTCTC-1	CEU
ATTTCTGTCCGGGTGT-1	CEU
ATTTCTGTCCTATTCA-1	YRI
ATTTCTGTCCTCGCAT-1	YRI
ATTTCTGTCCTGTACC-1	CEU
ATTTCTGTCTTGTTTG-1	YRI
CAACCAAAGACTAAGT-1	YRI
CAACCAAAGATAGTCA-1	CEU
CAACCAAAGCCGCCTA-1	CEU
CAACCAAAGGCCGAAT-1	YRI
CAACCAAAGGTTCCTA-1	YRI
CAACCAACAACGATGG-1	YRI
CAACCAACAATGACCT-1	YRI
CAACCAACATGGTCAT-1	YRI
CAACCAAGTCATTAGC-1	CEU
CAACCAATCATGTGGT-1	YRI
CAACCAATCCCATTAT-1	YRI
CAACCAATCCTTGACC-1	YRI
CAACCAATCGCCAAAT-1	CEU
CAACCTCAGCAATATG-1	YRI
CAACCTCAGCAGCGTA-1	YRI
CAACCTCAGCCAGGAT-1	YRI
CAACCTCAGTGAATTG-1	YRI
CAACCTCCACGACGAA-1	YRI
CAACCTCCATCTGGTA-1	CEU
CAACCTCCATGTAGTC-1	CEU
CAACCTCGTACCCAAT-1	YRI
CAACCTCGTCATATGC-1	YRI
CAACCTCGTTAAGTAG-1	CEU
CAACCTCGTTACCGAT-1	CEU
CAACCTCTCACCTCGT-1	YRI
CAACCTCTCAGGCAAG-1	YRI
CAACCTCTCCAAATGC-1	YRI
CAACCTCTCTTTAGTC-1	YRI
CAACTAGAGACCTAGG-1	CEU
CAACTAGAGCAATCTC-1	CEU
CAACTAGAGCCACGTC-1	CEU
CAACTAGCACCTTGTC-1	YRI
CAACTAGCATAAGACA-1	CEU
CAACTAGCATAGGATA-1	YRI
CAACTAGCATGTCCTC-1	YRI
CAACTAGGTAAGTGGC-1	YRI
CAACTAGGTAGGCATG-1	YRI
CAACTAGGTCGAGTTT-1	YRI
CAACTAGTCACGCGGT-1	YRI
CAACTAGTCCGAATGT-1	YRI
CAACTAGTCCTGCTTG-1	YRI
CAAGAAAAGAATTCCC-1	YRI
CAAGAAAAGCCCAGCT-1	CEU
CAAGAAAAGTATGACA-1	YRI
CAAGAAACACAAGCCC-1	CEU
CAAGAAAGTAAGGATT-1	CEU
CAAGAAAGTCAAAGCG-1	YRI
CAAGAAAGTCGCATCG-1	CEU
CAAGAAAGTCGTCTTC-1	YRI
CAAGAAAGTGCCTGGT-1	YRI
CAAGAAATCGAGGTAG-1	YRI
CAAGAAATCTCCAACC-1	YRI
CAAGATCAGAAGGCCT-1	YRI
CAAGATCAGAAGGTGA-1	CEU
CAAGATCAGCTCCTCT-1	YRI
CAAGATCAGTCCATAC-1	YRI
CAAGATCCACAACTGT-1	YRI
CAAGATCCATGCTAGT-1	YRI
CAAGATCGTAAAGTCA-1	YRI
CAAGATCGTAAATGAC-1	CEU
CAAGATCTCGCAGGCT-1	CEU
CAAGGCCAGAGTTGGC-1	CEU
CAAGGCCAGGATCGCA-1	YRI
CAAGGCCCACAGTCGC-1	YRI
CAAGGCCCACTGTTAG-1	CEU
CAAGGCCCAGGTGCCT-1	CEU
CAAGGCCGTGTGCGTC-1	CEU
CAAGGCCGTTACCGAT-1	YRI
CAAGGCCGTTCAGCGC-1	CEU
CAAGGCCTCAACGGCC-1	CEU
CAAGGCCTCGAATGCT-1	YRI
CAAGGCCTCGTGACAT-1	YRI
CAAGTTGAGGCATGTG-1	CEU
CAAGTTGAGGCCGAAT-1	CEU
CAAGTTGAGTCATCCA-1	YRI
CAAGTTGCAACACGCC-1	YRI
CAAGTTGCACCGAATT-1	YRI
CAAGTTGCATACGCCG-1	YRI
CAAGTTGCATGCAACT-1	YRI
CAAGTTGGTACCGGCT-1	YRI
CAAGTTGGTCTTGCGG-1	CEU
CAAGTTGGTCTTGTCC-1	YRI
CAAGTTGGTGGCAAAC-1	CEU
CAAGTTGTCAGATAAG-1	CEU
CAAGTTGTCAGCTTAG-1	YRI
CAAGTTGTCGCGATCG-1	CEU
CAAGTTGTCTCGGACG-1	YRI
CAAGTTGTCTGCGGCA-1	CEU
CACAAACAGCGTAGTG-1	YRI
CACAAACAGTCTCAAC-1	YRI
CACAAACCAAGGTTTC-1	CEU
CACAAACCAATCCAAC-1	CEU
CACAAACGTACGCACC-1	YRI
CACAAACGTCTAGTCA-1	CEU
CACAAACGTTCCCGAG-1	CEU
CACAAACTCAACGCTA-1	YRI
CACAAACTCGTATCAG-1	CEU
CACAAACTCTGCAGTA-1	YRI
CACACAAAGAATGTGT-1	YRI
CACACAAAGACCGGAT-1	YRI
CACACAAAGACTAAGT-1	YRI
CACACAAAGGCAGTCA-1	CEU
CACACAACAAGCCGCT-1	CEU
CACACAACAAGCTGTT-1	YRI
CACACAACAATAACGA-1	YRI
CACACAACAATCTACG-1	CEU
CACACAACACGCTTTC-1	CEU
CACACAACATAAAGGT-1	CEU
CACACAAGTCAAAGCG-1	YRI
CACACAAGTCTAGAGG-1	YRI
CACACAATCAGTACGT-1	YRI
CACACAATCCTGTAGA-1	YRI
CACACCTAGCATCATC-1	YRI
CACACCTAGTGTTAGA-1	YRI
CACACCTAGTTCGCGC-1	CEU
CACACCTCAAGCGCTC-1	CEU
CACACCTCACCGTTGG-1	CEU
CACACCTCAGCCACCA-1	YRI
CACACCTCATACAGCT-1	YRI
CACACCTCATACGCCG-1	CEU
CACACCTCATGTAGTC-1	YRI
CACACCTTCCTAAGTG-1	YRI
CACACCTTCCTAGGGC-1	YRI
CACACCTTCCTAGTGA-1	CEU
CACACCTTCTAAGCCA-1	YRI
CACACCTTCTCAACTT-1	YRI
CACACCTTCTTAACCT-1	YRI
CACACTCAGTGATCGG-1	CEU
CACACTCCACAACGTT-1	CEU
CACACTCCACAGTCGC-1	YRI
CACACTCCACGGTAGA-1	YRI
CACACTCCAGCATGAG-1	CEU
CACACTCTCCATGCTC-1	CEU
CACACTCTCGTCTGCT-1	YRI
CACAGGCAGAAGGTGA-1	CEU
CACAGGCAGCCAGGAT-1	YRI
CACAGGCAGTACGCGA-1	CEU
CACAGGCCACATGACT-1	YRI
CACAGGCCAGTTCCCT-1	YRI
CACAGGCCATACTACG-1	YRI
CACAGGCCATGCCTTC-1	CEU
CACAGGCGTCTCACCT-1	YRI
CACAGGCGTGTATGGG-1	YRI
CACAGGCGTTCAGTAC-1	CEU
CACAGGCTCGCATGAT-1	YRI
CACAGGCTCTCTAGGA-1	YRI
CACAGTAAGAGTCGGT-1	YRI
CACAGTAAGATCCCAT-1	YRI
CACAGTAAGCCCGAAA-1	CEU
CACAGTACACAGACTT-1	YRI
CACAGTACAGCCTTGG-1	YRI
CACAGTACAGTCCTTC-1	CEU
CACAGTACATACTACG-1	CEU
CACAGTACATCCGGGT-1	YRI
CACAGTATCACCTCGT-1	CEU
CACATAGAGGCTAGAC-1	CEU
CACATAGAGTGGTAGC-1	CEU
CACATAGAGTTGCAGG-1	CEU
CACATAGCACCCATTC-1	YRI
CACATAGCAGATGGGT-1	YRI
CACATAGCAGTATGCT-1	YRI
CACATAGCATGTCTCC-1	CEU
CACATAGGTCGTCTTC-1	CEU
CACATAGTCCTATTCA-1	YRI
CACATAGTCCTGTACC-1	CEU
CACATAGTCGTCTGCT-1	CEU
CACATAGTCTGAAAGA-1	YRI
CACATAGTCTTTAGTC-1	YRI
CACATTTAGAGGTTGC-1	CEU
CACATTTAGGTTACCT-1	YRI
CACATTTCATCCGCGA-1	YRI
CACATTTGTAGTACCT-1	CEU
CACATTTGTCCGCTGA-1	CEU
CACATTTGTCGCATAT-1	CEU
CACATTTGTCTTGATG-1	CEU
CACATTTGTCTTGTCC-1	YRI
CACATTTGTGTGTGCC-1	CEU
CACATTTGTTGATTCG-1	YRI
CACATTTTCCAACCAA-1	YRI
CACATTTTCGGCGCAT-1	YRI
CACCACTAGTGCTGCC-1	YRI
CACCACTAGTTATCGC-1	YRI
CACCACTCAAAGCAAT-1	CEU
CACCACTCAGATCGGA-1	CEU
CACCACTCAGATCTGT-1	YRI
CACCACTCAGGATCGA-1	YRI
CACCACTGTCCGTCAG-1	CEU
CACCACTGTGTTGGGA-1	YRI
CACCACTTCACAACGT-1	YRI
CACCACTTCACCGTAA-1	CEU
CACCACTTCACTTATC-1	CEU
CACCACTTCTGACCTC-1	YRI
CACCACTTCTTGAGGT-1	YRI
CACCAGGAGAGGTAGA-1	CEU
CACCAGGAGCGCCTCA-1	YRI
CACCAGGAGTCAAGCG-1	CEU
CACCAGGCAGATTGCT-1	YRI
CACCAGGCATCAGTAC-1	YRI
CACCAGGGTCCGTCAG-1	YRI
CACCAGGGTCGAGATG-1	CEU
CACCAGGGTCGCGAAA-1	YRI
CACCAGGGTGTAATGA-1	CEU
CACCAGGGTTCCACAA-1	CEU
CACCTTGAGCTGATAA-1	YRI
CACCTTGAGTGGTAGC-1	YRI
CACCTTGCAATGTAAG-1	CEU
CACCTTGCAGCTGTAT-1	YRI
CACCTTGCAGGGTACA-1	CEU
CACCTTGCATCTATGG-1	YRI
CACCTTGGTAAGTGTA-1	YRI
CACCTTGGTCACTGGC-1	YRI
CACCTTGTCATCGGAT-1	YRI
CACCTTGTCCCTCTTT-1	YRI
CACCTTGTCTACTCAT-1	YRI
CACTCCAAGCAGGTCA-1	CEU
CACTCCACAAGTAATG-1	YRI
CACTCCACACGAGAGT-1	YRI
CACTCCACAGCGAACA-1	YRI
CACTCCAGTACCGGCT-1	CEU
CACTCCAGTACTCTCC-1	CEU
CACTCCAGTGTAATGA-1	YRI
CACTCCAGTTGGTTTG-1	YRI
CACTCCATCACAAACC-1	CEU
CAGAATCAGAAACGCC-1	YRI
CAGAATCAGAGGTTGC-1	YRI
CAGAATCAGGTGGGTT-1	YRI
CAGAATCAGTCAAGCG-1	YRI
CAGAATCCAAACGCGA-1	YRI
CAGAATCCAAGCCGTC-1	CEU
CAGAATCCAATCACAC-1	YRI
CAGAATCCACCCATGG-1	CEU
CAGAATCCACGCCAGT-1	CEU
CAGAATCCAGCTCGAC-1	YRI
CAGAATCCAGTTAACC-1	CEU
CAGAATCCATGTCTCC-1	YRI
CAGAATCCATTCCTCG-1	CEU
CAGAATCGTACGACCC-1	CEU
CAGAATCGTGAGTGAC-1	CEU
CAGAATCTCAGCTCTC-1	YRI
CAGAATCTCCAGGGCT-1	YRI
CAGAGAGAGATATGCA-1	YRI
CAGAGAGCATAAAGGT-1	YRI
CAGAGAGGTAACGCGA-1	CEU
CAGAGAGGTAGGGTAC-1	CEU
CAGAGAGGTGGTGTAG-1	YRI
CAGAGAGGTTCGCGAC-1	CEU
CAGAGAGGTTGAGGTG-1	CEU
CAGATCAAGCTGTCTA-1	CEU
CAGATCAAGGAGTACC-1	YRI
CAGATCAAGTCGTTTG-1	YRI
CAGATCACAACTGCTA-1	YRI
CAGATCACAGTCAGCC-1	CEU
CAGATCACATGTCGAT-1	CEU
CAGATCACATTGGCGC-1	CEU
CAGATCAGTATCTGCA-1	YRI
CAGATCAGTCTCTCTG-1	YRI
CAGATCAGTTACTGAC-1	CEU
CAGATCAGTTGATTGC-1	CEU
CAGATCATCAAACCGT-1	YRI
CAGATCATCACGCATA-1	YRI
CAGATCATCAGAGCTT-1	YRI
CAGATCATCCCTAACC-1	YRI
CAGATCATCTTGTCAT-1	CEU
CAGCAGCAGAGCTGGT-1	YRI
CAGCAGCAGGAGCGTT-1	YRI
CAGCAGCAGGGTATCG-1	YRI
CAGCAGCCAAACGTGG-1	CEU
CAGCAGCCACGTCAGC-1	YRI
CAGCAGCCATAGAAAC-1	YRI
CAGCAGCCATATACCG-1	CEU
CAGCAGCCATGTCCTC-1	YRI
CAGCAGCGTCCTCCAT-1	YRI
CAGCAGCGTGCAACGA-1	YRI
CAGCAGCGTGGAAAGA-1	CEU
CAGCAGCTCACCTCGT-1	CEU
CAGCAGCTCATACGGT-1	CEU
CAGCAGCTCGTCGTTC-1	YRI
CAGCAGCTCTTCAACT-1	YRI
CAGCAGCTCTTTACAC-1	YRI
CAGCATAAGACTCGGA-1	YRI
CAGCATAAGCTTTGGT-1	CEU
CAGCATAAGGTCATCT-1	CEU
CAGCATACAACGCACC-1	CEU
CAGCATAGTATAGTAG-1	YRI
CAGCATAGTTAAGACA-1	CEU
CAGCATAGTTACAGAA-1	YRI
CAGCATAGTTCCACGG-1	YRI
CAGCATATCACCATAG-1	CEU
CAGCATATCAGCGATT-1	CEU
CAGCATATCCGCATAA-1	YRI
CAGCCGAAGACCTAGG-1	YRI
CAGCCGAAGTGGACGT-1	CEU
CAGCCGACACAGGAGT-1	CEU
CAGCCGACATCTACGA-1	CEU
CAGCCGAGTGAGTATA-1	YRI
CAGCCGAGTGGGTATG-1	CEU
CAGCCGAGTTCTGAAC-1	YRI
CAGCCGATCCCTAATT-1	CEU
CAGCCGATCGAATGCT-1	YRI
CAGCCGATCTGGTTCC-1	CEU
CAGCCGATCTTGAGAC-1	CEU
CAGCCGATCTTTACAC-1	YRI
CAGCGACAGGTGTTAA-1	CEU
CAGCGACAGTACCGGA-1	YRI
CAGCGACAGTTCCACA-1	YRI
CAGCGACCAAAGTGCG-1	YRI
CAGCGACCAGCCACCA-1	YRI
CAGCGACCAGCCTGTG-1	YRI
CAGCGACGTGAGCGAT-1	YRI
CAGCGACTCCTGCTTG-1	CEU
CAGCGACTCGTTGACA-1	YRI
CAGCTAAAGCACACAG-1	CEU
CAGCTAAAGCCCTAAT-1	CEU
CAGCTAAAGCTACCGC-1	CEU
CAGCTAAAGTTGAGTA-1	YRI
CAGCTAACAAAGGCGT-1	YRI
CAGCTAACAAGTAGTA-1	YRI
CAGCTAACACTAAGTC-1	YRI
CAGCTAACAGGGAGAG-1	YRI
CAGCTAACATCTCCCA-1	YRI
CAGCTAAGTGTAATGA-1	CEU
CAGCTAAGTTAAGACA-1	CEU
CAGCTAAGTTCCACTC-1	YRI
CAGCTAATCATTGCGA-1	CEU
CAGCTAATCGTCTGAA-1	YRI
CAGCTAATCTGAGTGT-1	CEU
CAGCTGGAGACAATAC-1	YRI
CAGCTGGAGCTAAGAT-1	YRI
CAGCTGGAGGTGCTAG-1	YRI
CAGCTGGAGTGAAGTT-1	YRI
CAGCTGGCACAAGCCC-1	CEU
CAGCTGGCATCGGACC-1	CEU
CAGCTGGCATGGTTGT-1	CEU
CAGGTGCAGAGTAATC-1	YRI
CAGGTGCAGATGAGAG-1	CEU
CAGGTGCAGCCGGTAA-1	CEU
CAGGTGCAGCTGCAAG-1	CEU
CAGGTGCAGGTTCCTA-1	CEU
CAGGTGCAGTCTCGGC-1	YRI
CAGGTGCCAAGGTTTC-1	CEU
CAGGTGCCACACGCTG-1	YRI
CAGGTGCCAGCGAACA-1	YRI
CAGGTGCCATACAGCT-1	CEU
CAGGTGCCATCCGCGA-1	YRI
CAGGTGCCATGTAAGA-1	YRI
CAGGTGCGTACAGTGG-1	YRI
CAGGTGCGTGCAACGA-1	CEU
CAGGTGCGTTGAGTTC-1	YRI
CAGGTGCTCCGTTGCT-1	YRI
CAGGTGCTCCTTTCGG-1	CEU
CAGGTGCTCTGCTGCT-1	YRI
CAGTAACAGACAGGCT-1	CEU
CAGTAACAGCAAATCA-1	YRI
CAGTAACAGTGGTAAT-1	YRI
CAGTAACCAAGCGCTC-1	YRI
CAGTAACCATGGATGG-1	YRI
CAGTAACCATTCTCAT-1	YRI
CAGTAACGTAAGAGGA-1	CEU
CAGTAACGTAGCGTGA-1	YRI
CAGTCCTAGGATGGAA-1	YRI
CAGTCCTAGTGACATA-1	CEU
CAGTCCTCATCGGTTA-1	YRI
CAGTCCTGTATGCTTG-1	YRI
CAGTCCTGTCACACGC-1	YRI
CAGTCCTGTTGACGTT-1	CEU
CAGTCCTTCCCATTTA-1	YRI
CAGTCCTTCCCTGACT-1	YRI
CAGTCCTTCGCTTGTC-1	YRI
CAGTCCTTCGGTTCGG-1	YRI
CATATGGAGACAGGCT-1	YRI
CATATGGAGCCCAGCT-1	YRI
CATATGGAGTTGAGTA-1	YRI
CATATGGCACTTCGAA-1	CEU
CATATGGCAGTATCTG-1	YRI
CATATGGGTAAATGTG-1	CEU
CATATGGGTCGGCTCA-1	YRI
CATATGGGTCTGATCA-1	CEU
CATATGGGTGTCAATC-1	CEU
CATATTCAGAATGTTG-1	CEU
CATATTCAGCGATTCT-1	YRI
CATATTCCACTTACGA-1	CEU
CATATTCCATCTACGA-1	CEU
CATATTCGTAGCTAAA-1	CEU
CATATTCTCCGTACAA-1	YRI
CATATTCTCCTCAACC-1	YRI
CATCAAGCACGACGAA-1	YRI
CATCAAGCACGAGAGT-1	YRI
CATCAAGCACTAGTAC-1	YRI
CATCAAGCAGTATAAG-1	YRI
CATCAAGCATTCCTGC-1	CEU
CATCAAGGTAGAAGGA-1	YRI
CATCAAGGTAGCTAAA-1	YRI
CATCAAGGTCCTAGCG-1	CEU
CATCAAGTCATACGGT-1	CEU
CATCAAGTCCACGAAT-1	YRI
CATCAAGTCCTACAGA-1	YRI
CATCAAGTCCTATTCA-1	YRI
CATCAAGTCTTGAGAC-1	CEU
CATCAGAAGAGTCTGG-1	YRI
CATCAGAAGATATGGT-1	CEU
CATCAGAAGCTGCAAG-1	CEU
CATCAGACACAACTGT-1	CEU
CATCAGACAGCCTATA-1	YRI
CATCAGAGTCGAGTTT-1	CEU
CATCAGAGTCGCGAAA-1	YRI
CATCAGAGTGTCCTCT-1	YRI
CATCAGATCAAACCAC-1	YRI
CATCAGATCACGATGT-1	YRI
CATCAGATCGCTTAGA-1	YRI
CATCAGATCTTAGAGC-1	CEU
CATCCACAGATCCTGT-1	YRI
CATCCACAGATTACCC-1	YRI
CATCCACAGCTATGCT-1	CEU
CATCCACAGGCTAGGT-1	CEU
CATCCACAGTGTCCCG-1	YRI
CATCCACCAATTGCTG-1	CEU
CATCCACCACCAGGTC-1	YRI
CATCCACGTCACTGGC-1	YRI
CATCCACGTCGGCATC-1	CEU
CATCGAAAGAGATGAG-1	CEU
CATCGAAAGGACCACA-1	YRI
CATCGAAAGGGTGTTG-1	CEU
CATCGAACAACAACCT-1	CEU
CATCGAACAGCCAGAA-1	YRI
CATCGAAGTGTGACGA-1	YRI
CATCGAAGTTATGTGC-1	CEU
CATCGAATCAGGTTCA-1	CEU
CATCGAATCATCGATG-1	YRI
CATCGAATCGCCGTGA-1	CEU
CATCGAATCGTTGCCT-1	YRI
CATCGAATCTCCGGTT-1	CEU
CATCGAATCTGTTTGT-1	YRI
CATCGGGAGCAACGGT-1	CEU
CATCGGGAGTGCGATG-1	YRI
CATCGGGAGTGTACCT-1	YRI
CATCGGGCAAGCTGGA-1	YRI
CATCGGGCACAGACTT-1	YRI
CATCGGGCACCACCAG-1	YRI
CATCGGGGTGCTTCTC-1	CEU
CATCGGGTCAGAAATG-1	YRI
CATCGGGTCCTACAGA-1	YRI
CATCGGGTCGTTTGCC-1	YRI
CATCGGGTCTCTGTCG-1	CEU
CATGACAAGAGTAAGG-1	YRI
CATGACAAGTAGCGGT-1	CEU
CATGACACAATACGCT-1	CEU
CATGACACAATGGAAT-1	YRI
CATGACACACTCTGTC-1	YRI
CATGACACACTTCGAA-1	CEU
CATGACACAGCTTCGG-1	YRI
CATGACAGTAGAGGAA-1	YRI
CATGACAGTTCCATGA-1	YRI
CATGACATCCGGCACA-1	YRI
CATGACATCGGAGCAA-1	YRI
CATGACATCGGCGCTA-1	CEU
CATGACATCTCAAACG-1	YRI
CATGACATCTTACCGC-1	CEU
CATGCCTAGCCAGTTT-1	CEU
CATGCCTAGGGTTCCC-1	CEU
CATGCCTAGGTCATCT-1	YRI
CATGCCTAGGTGATTA-1	YRI
CATGCCTCAAAGAATC-1	YRI
CATGCCTCAACTGGCC-1	CEU
CATGCCTCACAGATTC-1	CEU
CATGCCTGTAGGACAC-1	YRI
CATGCCTGTCAGAGGT-1	CEU
CATGCCTGTGATGATA-1	YRI
CATGCCTGTTACCGAT-1	YRI
CATGCCTGTTCCACGG-1	YRI
CATGCCTTCACGACTA-1	CEU
CATGCCTTCCTTTCTC-1	CEU
CATGCCTTCGCGTTTC-1	YRI
CATGCCTTCTTGCCGT-1	CEU
CATGGCGAGGCCCTCA-1	CEU
CATGGCGAGTCTTGCA-1	YRI
CATGGCGAGTTTGCGT-1	CEU
CATGGCGCAAAGGTGC-1	YRI
CATGGCGCAAGTTAAG-1	CEU
CATGGCGCACGGTGTC-1	YRI
CATGGCGCAGATGGCA-1	YRI
CATGGCGCATGCAATC-1	YRI
CATGGCGCATGCGCAC-1	YRI
CATGGCGGTCAAACTC-1	YRI
CATGGCGGTGCAGGTA-1	CEU
CATGGCGGTGGCCCTA-1	YRI
CATGGCGTCCACGACG-1	CEU
CATGGCGTCCAGGGCT-1	YRI
CATGGCGTCCCGGATG-1	CEU
CATGGCGTCGCCGTGA-1	YRI
CATGGCGTCGGAGGTA-1	CEU
CATTATCAGAGGGCTT-1	YRI
CATTATCAGCGCTTAT-1	YRI
CATTATCAGGGAAACA-1	YRI
CATTATCCACCGGAAA-1	YRI
CATTATCCAGCTTCGG-1	YRI
CATTATCGTACCGTTA-1	YRI
CATTATCGTCGTTGTA-1	CEU
CATTATCGTCTTCTCG-1	YRI
CATTATCGTGAAAGAG-1	YRI
CATTATCGTGATGTCT-1	CEU
CATTATCTCTCCAACC-1	YRI
CATTATCTCTGTCAAG-1	YRI
CATTCGCAGAAACCAT-1	YRI
CATTCGCAGATACACA-1	YRI
CATTCGCAGCGTTGCC-1	YRI
CATTCGCAGGAGCGAG-1	CEU
CATTCGCAGTGCCAGA-1	YRI
CATTCGCCACTTAACG-1	YRI
CATTCGCCATGCAATC-1	YRI
CATTCGCGTACCCAAT-1	YRI
CATTCGCGTAGCGTAG-1	YRI
CATTCGCGTCTACCTC-1	CEU
CATTCGCGTGTAATGA-1	YRI
CATTCGCTCAGCTGGC-1	CEU
CATTCGCTCCAAATGC-1	CEU
CATTCGCTCGCCTGTT-1	YRI
CATTCGCTCGGCGGTT-1	CEU
CCAATCCAGAGTGACC-1	CEU
CCAATCCAGCGCTTAT-1	CEU
CCAATCCAGGCTAGCA-1	CEU
CCAATCCCAAACCTAC-1	CEU
CCAATCCCAACACGCC-1	CEU
CCAATCCCAAGAAGAG-1	CEU
CCAATCCCAAGCGATG-1	YRI
CCAATCCCAAGTCTGT-1	CEU
CCAATCCCACATCTTT-1	YRI
CCAATCCCACTTCTGC-1	YRI
CCAATCCGTCCTGCTT-1	CEU
CCAATCCGTGCTAGCC-1	YRI
CCAATCCTCCGATATG-1	CEU
CCAATCCTCCTGCCAT-1	CEU
CCAATCCTCGAATGGG-1	CEU
CCACCTAAGAATGTGT-1	CEU
CCACCTAAGACCTAGG-1	CEU
CCACCTAAGATGTAAC-1	CEU
CCACCTAAGCCAGTAG-1	CEU
CCACCTACACATGGGA-1	CEU
CCACCTACACTCTGTC-1	YRI
CCACCTACAGTTCCCT-1	CEU
CCACCTAGTCTTCAAG-1	YRI
CCACCTATCACTTATC-1	YRI
CCACCTATCCAAATGC-1	CEU
CCACCTATCGTTTAGG-1	YRI
CCACGGAAGAACAACT-1	YRI
CCACGGAAGAAGAAGC-1	CEU
CCACGGACACGAAGCA-1	YRI
CCACGGACAGGTGCCT-1	CEU
CCACGGACATACGCCG-1	CEU
CCACGGAGTACTTGAC-1	YRI
CCACGGAGTAGGGTAC-1	YRI
CCACGGATCACCTTAT-1	YRI
CCACGGATCATGCAAC-1	CEU
CCACGGATCCAACCAA-1	CEU
CCACTACAGCACCGTC-1	YRI
CCACTACAGTCCGTAT-1	CEU
CCACTACAGTTTAGGA-1	YRI
CCACTACCAAACGTGG-1	YRI
CCACTACGTAAATGAC-1	YRI
CCACTACTCATACGGT-1	YRI
CCACTACTCCGAACGC-1	YRI
CCACTACTCCTAGTGA-1	YRI
CCACTACTCGTACGGC-1	YRI
CCACTACTCGTAGATC-1	YRI
CCACTACTCTGACCTC-1	CEU
CCACTACTCTGCTGTC-1	YRI
CCAGCGAAGCGATGAC-1	YRI
CCAGCGAAGCGATTCT-1	YRI
CCAGCGAAGCTAAGAT-1	YRI
CCAGCGAAGTATCGAA-1	YRI
CCAGCGACATCTCGCT-1	YRI
CCAGCGACATTCGACA-1	YRI
CCAGCGAGTTTGTGTG-1	YRI
CCAGCGATCGCGATCG-1	YRI
CCATGTCAGACAAAGG-1	YRI
CCATGTCAGAGTAATC-1	YRI
CCATGTCAGCTGAACG-1	CEU
CCATGTCAGGCCCTTG-1	YRI
CCATGTCCAACGATGG-1	CEU
CCATGTCCAGACACTT-1	YRI
CCATGTCTCACCCTCA-1	CEU
CCATGTCTCCCTCTTT-1	YRI
CCATGTCTCCTGCAGG-1	YRI
CCATGTCTCTGCTGCT-1	CEU
CCATTCGAGATAGGAG-1	CEU
CCATTCGAGTATCTCG-1	YRI
CCATTCGCAGACGCCT-1	YRI
CCATTCGCAGAGTGTG-1	CEU
CCATTCGCAGGTTTCA-1	YRI
CCATTCGCATCGGGTC-1	CEU
CCATTCGCATTCGACA-1	CEU
CCATTCGGTAACGCGA-1	CEU
CCATTCGTCAAGATCC-1	CEU
CCATTCGTCTAACCGA-1	CEU
CCATTCGTCTAACTTC-1	CEU
CCCAATCAGATGTTAG-1	YRI
CCCAATCAGCGTTGCC-1	YRI
CCCAATCCAGTAAGCG-1	YRI
CCCAATCCAGTCACTA-1	CEU
CCCAATCGTACAGACG-1	CEU
CCCAATCGTATATGAG-1	YRI
CCCAATCGTCAAAGAT-1	CEU
CCCAATCGTGCGCTTG-1	CEU
CCCAATCGTTTAGCTG-1	YRI
CCCAATCTCAATCTCT-1	CEU
CCCAATCTCCAGTATG-1	CEU
CCCAATCTCGTACGGC-1	YRI
CCCAGTTAGAGTACAT-1	CEU
CCCAGTTAGCACCGCT-1	CEU
CCCAGTTAGGATGTAT-1	CEU
CCCAGTTCACGTCAGC-1	CEU
CCCAGTTCACGTCTCT-1	CEU
CCCAGTTCAGGTCGTC-1	YRI
CCCAGTTGTACAGTTC-1	YRI
CCCAGTTGTCTCCACT-1	CEU
CCCAGTTTCAATCACG-1	YRI
CCCAGTTTCATTATCC-1	YRI
CCCAGTTTCTGTCAAG-1	YRI
CCCATACAGCGATATA-1	YRI
CCCATACAGCTGCGAA-1	YRI
CCCATACAGGGTTTCT-1	YRI
CCCATACAGTGTTAGA-1	CEU
CCCATACGTACATCCA-1	YRI
CCCATACTCGATGAGG-1	YRI
CCCTCCTAGAATGTTG-1	YRI
CCCTCCTAGTGTTTGC-1	CEU
CCCTCCTCACAAGACG-1	CEU
CCCTCCTCACCGAAAG-1	CEU
CCCTCCTCAGGACCCT-1	YRI
CCCTCCTGTAAGTGGC-1	YRI
CCCTCCTGTCAGAATA-1	YRI
CCCTCCTGTGTATGGG-1	YRI
CCCTCCTGTGTGAAAT-1	CEU
CCCTCCTTCAAACCGT-1	CEU
CCCTCCTTCGTGGGAA-1	CEU
CCGGGATAGAAAGTGG-1	YRI
CCGGGATAGAGCCTAG-1	0
CCGGGATAGTGTTTGC-1	CEU
CCGGGATGTACTTCTT-1	CEU
CCGGGATGTCATATGC-1	YRI
CCGGGATGTCTTGATG-1	CEU
CCGGGATGTGCGATAG-1	CEU
CCGGGATGTTAAAGTG-1	YRI
CCGGGATTCAACCAAC-1	YRI
CCGGGATTCTACCAGA-1	CEU
CCGGTAGAGACATAAC-1	YRI
CCGGTAGAGCTAAACA-1	CEU
CCGGTAGAGTGAACAT-1	YRI
CCGGTAGCAAGAAAGG-1	YRI
CCGGTAGGTACCCAAT-1	YRI
CCGGTAGGTCCTCTTG-1	YRI
CCGGTAGGTCGCTTCT-1	CEU
CCGGTAGGTGTGTGCC-1	YRI
CCGGTAGTCACAGTAC-1	YRI
CCGGTAGTCCACGTGG-1	YRI
CCGGTAGTCCCACTTG-1	YRI
CCGGTAGTCCTACAGA-1	YRI
CCGGTAGTCGCTAGCG-1	CEU
CCGGTAGTCTATCGCC-1	CEU
CCGTACTAGCGGATCA-1	YRI
CCGTACTAGGACACCA-1	CEU
CCGTACTAGGAGCGAG-1	CEU
CCGTACTAGGTGTGGT-1	YRI
CCGTACTCAACGATCT-1	YRI
CCGTACTCAAGCCCAC-1	YRI
CCGTACTCACTACAGT-1	CEU
CCGTACTCATCACGTA-1	CEU
CCGTACTGTAGCAAAT-1	YRI
CCGTACTGTGACGGTA-1	YRI
CCGTACTGTGGCCCTA-1	YRI
CCGTACTGTTTGGGCC-1	YRI
CCGTACTTCGTGTAGT-1	YRI
CCGTGGAAGACCTAGG-1	YRI
CCGTGGAAGATAGGAG-1	YRI
CCGTGGAAGCACCGTC-1	CEU
CCGTGGAAGCCGCCTA-1	YRI
CCGTGGAAGTGTGAAT-1	CEU
CCGTGGACAAGCGTAG-1	CEU
CCGTGGACAGGGTACA-1	YRI
CCGTGGACATGGAATA-1	CEU
CCGTGGAGTGTAATGA-1	YRI
CCGTGGAGTTCACCTC-1	CEU
CCGTGGAGTTCTGAAC-1	YRI
CCGTGGATCAGCGATT-1	YRI
CCGTTCAAGAAGGTTT-1	CEU
CCGTTCAAGCACGCCT-1	YRI
CCGTTCAAGCAGCGTA-1	YRI
CCGTTCAAGCTTTGGT-1	YRI
CCGTTCAAGGTGACCA-1	YRI
CCGTTCACACGGCCAT-1	CEU
CCGTTCACAGCTCCGA-1	YRI
CCGTTCACATATGAGA-1	CEU
CCGTTCAGTATGCTTG-1	CEU
CCGTTCAGTGAGGGTT-1	YRI
CCGTTCAGTTAGGGTG-1	YRI
CCGTTCAGTTATCGGT-1	YRI
CCGTTCAGTTGTGGAG-1	CEU
CCGTTCATCTGATTCT-1	YRI
CCTAAAGAGACGACGT-1	CEU
CCTAAAGAGGGTGTGT-1	CEU
CCTAAAGAGGGTTTCT-1	CEU
CCTAAAGAGTGCAAGC-1	YRI
CCTAAAGCAGCCTGTG-1	CEU
CCTAAAGCAGCCTTTC-1	YRI
CCTAAAGGTGCACCAC-1	YRI
CCTAAAGTCCTACAGA-1	CEU
CCTAAAGTCGCTAGCG-1	YRI
CCTAAAGTCGGCTACG-1	CEU
CCTACACAGGTAGCCA-1	YRI
CCTACACCAAAGTGCG-1	CEU
CCTACACCACAGTCGC-1	YRI
CCTACACGTCCAAGTT-1	CEU
CCTACACGTTCGGCAC-1	YRI
CCTACACGTTGCCTCT-1	YRI
CCTACACTCCCTAACC-1	YRI
CCTACCAAGAAACGCC-1	YRI
CCTACCAAGCCCAACC-1	CEU
CCTACCACACGTTGGC-1	YRI
CCTACCACACTAGTAC-1	YRI
CCTACCACATCTCCCA-1	CEU
CCTACCAGTCAGGACA-1	CEU
CCTACCAGTCTTGATG-1	CEU
CCTACCAGTGAAATCA-1	YRI
CCTACCAGTTCTGGTA-1	CEU
CCTACCATCGGCATCG-1	YRI
CCTACCATCTTGACGA-1	CEU
CCTAGCTAGCAGCCTC-1	YRI
CCTAGCTAGTACCGGA-1	YRI
CCTAGCTCACTCTGTC-1	YRI
CCTAGCTCAGATCTGT-1	YRI
CCTAGCTCAGTCAGAG-1	CEU
CCTAGCTGTATTCGTG-1	CEU
CCTAGCTGTTAAAGAC-1	YRI
CCTAGCTGTTTAGGAA-1	YRI
CCTAGCTTCAGCTGGC-1	YRI
CCTAGCTTCGCTGATA-1	YRI
CCTAGCTTCGGTCCGA-1	CEU
CCTAGCTTCTACGAGT-1	CEU
CCTAGCTTCTTGAGGT-1	YRI
CCTATTAAGAAGCCCA-1	YRI
CCTATTAAGGGCTCTC-1	YRI
CCTATTAAGTACGCCC-1	YRI
CCTATTACACGACTCG-1	CEU
CCTATTACAGCGTCCA-1	CEU
CCTATTACAGCTTCGG-1	CEU
CCTATTACAGTCAGCC-1	CEU
CCTATTACAGTCTTCC-1	YRI
CCTATTAGTAAATGAC-1	CEU
CCTATTATCAGCTCGG-1	YRI
CCTATTATCCGCGTTT-1	CEU
CCTATTATCGGCTACG-1	YRI
CCTATTATCGGTGTTA-1	YRI
CCTCAGTAGCTACCTA-1	CEU
CCTCAGTAGGAGTCTG-1	YRI
CCTCAGTCAAGTCTGT-1	YRI
CCTCAGTGTAACGACG-1	CEU
CCTCAGTGTCAAGCGA-1	YRI
CCTCAGTGTCATATGC-1	YRI
CCTCAGTGTCTAAAGA-1	YRI
CCTCAGTGTGAGCGAT-1	CEU
CCTCAGTGTTACCGAT-1	YRI
CCTCAGTTCCGGCACA-1	CEU
CCTCAGTTCCTTGCCA-1	CEU
CCTCTGAAGGCCATAG-1	YRI
CCTCTGACAGTCCTTC-1	YRI
CCTCTGAGTAGATTAG-1	CEU
CCTCTGAGTCTCTCTG-1	YRI
CCTCTGAGTTATGTGC-1	CEU
CCTCTGAGTTATTCTC-1	CEU
CCTCTGATCCACTGGG-1	YRI
CCTCTGATCGAATCCA-1	YRI
CCTCTGATCGTCTGCT-1	YRI
CCTCTGATCTCCCTGA-1	YRI
CCTCTGATCTGTTGAG-1	CEU
CCTTACGAGCAGCCTC-1	YRI
CCTTACGAGTGGTAGC-1	YRI
CCTTACGCAAGGTGTG-1	CEU
CCTTACGCAAGTCATC-1	CEU
CCTTACGCACATGACT-1	CEU
CCTTACGCACGAGGTA-1	CEU
CCTTACGCACGGTGTC-1	CEU
CCTTACGCAGATGGGT-1	YRI
CCTTACGCAGTTCCCT-1	CEU
CCTTACGGTCAGCTAT-1	YRI
CCTTACGGTCTGGTCG-1	YRI
CCTTACGGTGACTCAT-1	YRI
CCTTACGTCCTTGCCA-1	CEU
CCTTACGTCTCCAACC-1	YRI
CCTTCCCAGTTCGATC-1	YRI
CCTTCCCCAAACTGTC-1	CEU
CCTTCCCCACATAACC-1	CEU
CCTTCCCCAGGTCGTC-1	CEU
CCTTCCCCATTGCGGC-1	CEU
CCTTCCCGTAAATACG-1	CEU
CCTTCCCGTAAGGATT-1	CEU
CCTTCCCGTAGCGATG-1	YRI
CCTTCCCGTCGTGGCT-1	YRI
CCTTCCCGTGCTGTAT-1	CEU
CCTTCCCGTTAAAGTG-1	YRI
CCTTCCCTCGCCCTTA-1	YRI
CCTTCCCTCGGGAGTA-1	YRI
CCTTCCCTCGTTTAGG-1	YRI
CCTTCGAAGAAGGGTA-1	YRI
CCTTCGAAGAGTGACC-1	CEU
CCTTCGAAGGCTAGCA-1	YRI
CCTTCGAAGGGATACC-1	YRI
CCTTCGAAGGGTGTGT-1	CEU
CCTTCGAAGGGTTCCC-1	YRI
CCTTCGAAGTCCCACG-1	YRI
CCTTCGACAAGCGAGT-1	YRI
CCTTCGACATACGCCG-1	CEU
CCTTCGACATGCCTTC-1	CEU
CCTTCGACATGTCCTC-1	YRI
CCTTCGAGTACCAGTT-1	CEU
CCTTTCTAGAGACTAT-1	YRI
CCTTTCTAGATAGTCA-1	CEU
CCTTTCTAGCTGATAA-1	CEU
CCTTTCTAGGACACCA-1	YRI
CCTTTCTCACCCATTC-1	YRI
CCTTTCTCACGAGGTA-1	CEU
CCTTTCTCACGGCTAC-1	YRI
CCTTTCTCATCTGGTA-1	CEU
CCTTTCTCATGCATGT-1	CEU
CCTTTCTGTAACGCGA-1	CEU
CCTTTCTTCGCCAAAT-1	YRI
CGAACATAGAAGGCCT-1	YRI
CGAACATAGGAGCGTT-1	YRI
CGAACATAGGTTCCTA-1	YRI
CGAACATCACATTCGA-1	CEU
CGAACATCACGACTCG-1	YRI
CGAACATCACGCTTTC-1	YRI
CGAACATCATCTATGG-1	CEU
CGAACATCATGGTAGG-1	YRI
CGAACATGTTGAGTTC-1	YRI
CGAACATTCAGAAATG-1	YRI
CGAACATTCATAGCAC-1	YRI
CGAACATTCCCTAATT-1	YRI
CGAACATTCCTAGAAC-1	YRI
CGAACATTCGAATGCT-1	YRI
CGAATGTAGACAGACC-1	CEU
CGAATGTAGTGCCATT-1	CEU
CGAATGTGTAAGAGGA-1	CEU
CGAATGTGTCACCTAA-1	YRI
CGAATGTGTTTAGGAA-1	YRI
CGAATGTTCATGGTCA-1	YRI
CGAATGTTCGGAGGTA-1	YRI
CGAATGTTCTAACTCT-1	CEU
CGACCTTGTCCAAGTT-1	YRI
CGACCTTGTCCCGACA-1	YRI
CGACCTTTCCAAGTAC-1	CEU
CGACCTTTCCCACTTG-1	CEU
CGACCTTTCCCATTTA-1	YRI
CGACCTTTCCGAGCCA-1	YRI
CGACCTTTCTACTATC-1	YRI
CGACCTTTCTACTTAC-1	YRI
CGACCTTTCTAGCACA-1	YRI
CGACTTCAGCGATATA-1	CEU
CGACTTCAGTGAACGC-1	YRI
CGACTTCAGTGACATA-1	CEU
CGACTTCAGTGTACCT-1	YRI
CGACTTCCAATCCAAC-1	CEU
CGACTTCCACATCTTT-1	YRI
CGACTTCCACTCTGTC-1	YRI
CGACTTCCACTGTGTA-1	YRI
CGACTTCCATGTTCCC-1	YRI
CGACTTCGTATATGGA-1	YRI
CGACTTCGTCCGTGAC-1	YRI
CGACTTCGTGTCAATC-1	YRI
CGACTTCTCATACGGT-1	YRI
CGACTTCTCTTCATGT-1	YRI
CGAGAAGAGACTAAGT-1	YRI
CGAGAAGAGCGTCTAT-1	YRI
CGAGAAGAGTTACGGG-1	YRI
CGAGAAGCAAGCTGTT-1	YRI
CGAGAAGCACATGACT-1	YRI
CGAGAAGCACCACGTG-1	YRI
CGAGAAGCAGTATGCT-1	YRI
CGAGAAGGTAACGACG-1	CEU
CGAGAAGGTATGAAAC-1	YRI
CGAGAAGGTGGAAAGA-1	YRI
CGAGAAGGTGGCTCCA-1	YRI
CGAGAAGGTGGTAACG-1	YRI
CGAGAAGTCAGATAAG-1	YRI
CGAGAAGTCCAAAGTC-1	CEU
CGAGAAGTCCCATTTA-1	CEU
CGAGAAGTCCTTGACC-1	YRI
CGAGAAGTCGCCGTGA-1	YRI
CGAGCACAGCAGGTCA-1	YRI
CGAGCACAGTACTTGC-1	CEU
CGAGCACCAAGCTGTT-1	YRI
CGAGCACCACCTCGGA-1	CEU
CGAGCACCAGCTGCTG-1	YRI
CGAGCACCATGCCACG-1	CEU
CGAGCACCATGCCTTC-1	YRI
CGAGCACGTAGAGGAA-1	YRI
CGAGCACGTCGTTGTA-1	YRI
CGAGCACGTTACGGAG-1	YRI
CGAGCACGTTGCCTCT-1	YRI
CGAGCACGTTGCGCAC-1	YRI
CGAGCACTCAAAGTAG-1	YRI
CGAGCACTCCGCGTTT-1	CEU
CGAGCCAAGATAGTCA-1	CEU
CGAGCCAAGCAGACTG-1	CEU
CGAGCCAAGCTAAGAT-1	CEU
CGAGCCAAGCTAGGCA-1	YRI
CGAGCCAGTCTCCATC-1	CEU
CGAGCCAGTTACCAGT-1	CEU
CGAGCCAGTTCGTTGA-1	YRI
CGAGCCATCATCTGTT-1	0
CGAGCCATCCTTTACA-1	YRI
CGAGCCATCGTTTGCC-1	CEU
CGAGCCATCTACCAGA-1	YRI
CGATCGGAGAAGAAGC-1	CEU
CGATCGGAGACGCAAC-1	YRI
CGATCGGAGACTACAA-1	CEU
CGATCGGAGAGATGAG-1	YRI
CGATCGGAGGAGTACC-1	YRI
CGATCGGAGTACGCGA-1	YRI
CGATCGGCAATGGACG-1	YRI
CGATCGGGTAAGAGGA-1	YRI
CGATCGGGTAGATTAG-1	YRI
CGATCGGGTGTTCGAT-1	YRI
CGATCGGGTTATTCTC-1	YRI
CGATCGGTCCAGTATG-1	YRI
CGATCGGTCCTTGGTC-1	YRI
CGATGGCCACGTCAGC-1	CEU
CGATGGCCATGCCACG-1	YRI
CGATGGCGTATCGCAT-1	CEU
CGATGGCGTGAGTATA-1	CEU
CGATGGCTCGTCACGG-1	YRI
CGATGGCTCTCCAGGG-1	YRI
CGATGGCTCTTTAGGG-1	CEU
CGATGTAAGTGCGATG-1	CEU
CGATGTACAAGTAATG-1	CEU
CGATGTACACATCCGG-1	YRI
CGATGTACATGGATGG-1	YRI
CGATGTAGTGGGTATG-1	YRI
CGATGTATCAGCACAT-1	YRI
CGATGTATCAGCTTAG-1	YRI
CGATGTATCCAAGTAC-1	YRI
CGATGTATCCAGTATG-1	YRI
CGATTGAAGAATAGGG-1	CEU
CGATTGAAGACACTAA-1	YRI
CGATTGAAGTGTACCT-1	CEU
CGATTGACACAGGAGT-1	YRI
CGATTGACACTGCCAG-1	CEU
CGATTGACAGTCAGCC-1	CEU
CGATTGAGTACCCAAT-1	YRI
CGATTGAGTCAAAGAT-1	YRI
CGATTGAGTCTACCTC-1	YRI
CGATTGAGTGATGTCT-1	YRI
CGATTGAGTGCATCTA-1	YRI
CGATTGAGTTGACGTT-1	YRI
CGATTGATCATTTGGG-1	YRI
CGATTGATCCAAGTAC-1	YRI
CGATTGATCCGCGTTT-1	YRI
CGATTGATCCTAAGTG-1	CEU
CGATTGATCTCATTCA-1	YRI
CGATTGATCTGCGGCA-1	CEU
CGCCAAGAGAATGTGT-1	YRI
CGCCAAGAGGTAAACT-1	YRI
CGCCAAGAGTCCCACG-1	CEU
CGCCAAGCAAACGCGA-1	YRI
CGCCAAGCACCTGGTG-1	YRI
CGCCAAGCATAGACTC-1	YRI
CGCCAAGCATTTCACT-1	CEU
CGCCAAGGTAATAGCA-1	YRI
CGCCAAGGTCAAAGAT-1	YRI
CGCCAAGGTCTGATTG-1	CEU
CGCCAAGGTGCAACTT-1	YRI
CGCCAAGTCCCATTAT-1	YRI
CGCGGTAAGACATAAC-1	YRI
CGCGGTAAGACTAAGT-1	YRI
CGCGGTAAGAGTACAT-1	CEU
CGCGGTAAGCCCAACC-1	YRI
CGCGGTAAGCCGCCTA-1	YRI
CGCGGTAAGCTGCAAG-1	YRI
CGCGGTAAGGGTCGAT-1	YRI
CGCGGTAAGTATCGAA-1	YRI
CGCGGTACAATGAATG-1	CEU
CGCGGTATCATCTGCC-1	CEU
CGCGGTATCGGTGTCG-1	CEU
CGCGTTTAGACAGAGA-1	YRI
CGCGTTTAGAGAACAG-1	CEU
CGCGTTTAGCGATATA-1	YRI
CGCGTTTAGCGGCTTC-1	YRI
CGCGTTTAGCTAGGCA-1	YRI
CGCGTTTCATGCTAGT-1	YRI
CGCGTTTGTACTCGCG-1	CEU
CGCGTTTGTTACCAGT-1	YRI
CGCGTTTTCGGTGTTA-1	YRI
CGCGTTTTCTGCTGTC-1	YRI
CGCGTTTTCTTGTACT-1	YRI
CGCTATCAGAGGGCTT-1	CEU
CGCTATCAGTGTCCCG-1	YRI
CGCTATCAGTTGAGAT-1	YRI
CGCTATCCAACTGCTA-1	CEU
CGCTATCGTAGTACCT-1	CEU
CGCTATCGTCAAGCGA-1	YRI
CGCTATCGTCTTGTCC-1	CEU
CGCTATCGTTGATTGC-1	YRI
CGCTATCTCCAGGGCT-1	YRI
CGCTATCTCGTAGATC-1	CEU
CGCTATCTCTAGAGTC-1	YRI
CGCTGGAAGAGACGAA-1	CEU
CGCTGGAAGTTGAGAT-1	YRI
CGCTGGACAGCGAACA-1	CEU
CGCTGGAGTCGAACAG-1	YRI
CGCTGGAGTCGCATCG-1	YRI
CGCTGGAGTCTCCCTA-1	YRI
CGCTGGAGTGATAAAC-1	CEU
CGCTGGAGTTACAGAA-1	CEU
CGCTGGAGTTATGTGC-1	YRI
CGCTGGATCAGAAATG-1	YRI
CGCTGGATCAGCTCGG-1	CEU
CGCTGGATCCAAGTAC-1	YRI
CGCTGGATCGCTGATA-1	YRI
CGCTGGATCGTGACAT-1	YRI
CGCTTCAAGAAGGTTT-1	YRI
CGCTTCAAGACCTTTG-1	YRI
CGCTTCAAGACTTTCG-1	CEU
CGCTTCAAGGCTCTTA-1	YRI
CGCTTCAAGGGTGTGT-1	CEU
CGCTTCAGTAGCGTGA-1	YRI
CGCTTCAGTTAGGGTG-1	YRI
CGCTTCATCTTACCGC-1	YRI
CGGACACAGACACTAA-1	CEU
CGGACACAGCTTTGGT-1	CEU
CGGACACAGGCCCTCA-1	YRI
CGGACACAGGGCTTGA-1	YRI
CGGACACCAAGCCATT-1	YRI
CGGACACCATGTCTCC-1	YRI
CGGACACGTATATGGA-1	CEU
CGGACACGTTACGACT-1	YRI
CGGACACGTTCGTCTC-1	YRI
CGGACACTCAACACAC-1	YRI
CGGACACTCAGTCCCT-1	YRI
CGGACACTCCCTCAGT-1	YRI
CGGACACTCCGGGTGT-1	CEU
CGGACACTCGGATGGA-1	CEU
CGGACACTCTAGCACA-1	CEU
CGGACGTAGATGGGTC-1	YRI
CGGACGTAGCTTCGCG-1	CEU
CGGACGTAGTACCGGA-1	CEU
CGGACGTAGTCGTACT-1	YRI
CGGACGTCAATCACAC-1	YRI
CGGACGTCAGATGGCA-1	CEU
CGGACGTCATACTCTT-1	YRI
CGGACGTCATTGGTAC-1	YRI
CGGACGTGTAGGCATG-1	CEU
CGGACGTGTCACACGC-1	CEU
CGGACGTGTGAACCTT-1	CEU
CGGACGTGTGATGTGG-1	YRI
CGGACGTTCACGGTTA-1	CEU
CGGACGTTCCACGCAG-1	YRI
CGGACGTTCGGGAGTA-1	YRI
CGGACGTTCGTTACAG-1	YRI
CGGACTGAGCCGTCGT-1	CEU
CGGACTGAGGCTAGAC-1	YRI
CGGACTGCATTTCAGG-1	YRI
CGGACTGGTCACACGC-1	YRI
CGGACTGGTCCGAGTC-1	CEU
CGGACTGGTTCCAACA-1	CEU
CGGACTGGTTGTCTTT-1	YRI
CGGACTGTCTGTTGAG-1	CEU
CGGAGCTAGAAACCGC-1	CEU
CGGAGCTAGACTAAGT-1	CEU
CGGAGCTAGAGGTACC-1	CEU
CGGAGCTAGGGCTTCC-1	CEU
CGGAGCTAGTTTCCTT-1	CEU
CGGAGCTCAATGACCT-1	CEU
CGGAGCTCACCGTTGG-1	YRI
CGGAGCTCACGGTAGA-1	YRI
CGGAGCTCAGCTCGCA-1	YRI
CGGAGCTCATCACCCT-1	YRI
CGGAGCTCATTCGACA-1	YRI
CGGAGCTGTCACTTCC-1	YRI
CGGAGCTTCAACGCTA-1	YRI
CGGAGCTTCAATCACG-1	YRI
CGGAGCTTCACTATTC-1	YRI
CGGAGCTTCACTTCAT-1	CEU
CGGAGCTTCAGTGCAT-1	CEU
CGGAGTCAGAGTGACC-1	YRI
CGGAGTCAGCAGGCTA-1	YRI
CGGAGTCAGTCAATAG-1	CEU
CGGAGTCAGTCTTGCA-1	YRI
CGGAGTCCACTTCGAA-1	YRI
CGGAGTCCAGACAAGC-1	YRI
CGGAGTCGTACTCAAC-1	YRI
CGGAGTCGTCGCCATG-1	YRI
CGGAGTCGTCTCAACA-1	YRI
CGGAGTCGTGACCAAG-1	YRI
CGGAGTCGTTTGTTGG-1	CEU
CGGAGTCTCCCAAGAT-1	CEU
CGGAGTCTCCTAGAAC-1	CEU
CGGAGTCTCGATGAGG-1	CEU
CGGAGTCTCGTCACGG-1	YRI
CGGAGTCTCTCGCTTG-1	CEU
CGGAGTCTCTGCGGCA-1	YRI
CGGCTAGAGAGCTATA-1	YRI
CGGCTAGAGCCACGCT-1	CEU
CGGCTAGAGTCTCGGC-1	YRI
CGGCTAGCAGCTCGCA-1	YRI
CGGCTAGGTAAACACA-1	CEU
CGGCTAGGTCAACATC-1	YRI
CGGCTAGTCGAATGGG-1	CEU
CGGCTAGTCTCCTATA-1	YRI
CGGCTAGTCTGGTATG-1	YRI
CGGGTCAAGAAACGAG-1	CEU
CGGGTCAAGTGGTCCC-1	YRI
CGGGTCAAGTGTACCT-1	YRI
CGGGTCACACCAGCAC-1	CEU
CGGGTCACAGTGAGTG-1	YRI
CGGGTCACATATGAGA-1	CEU
CGGGTCAGTCAGAGGT-1	YRI
CGGGTCAGTCTCCACT-1	YRI
CGGGTCAGTTCCACTC-1	YRI
CGGGTCATCAGCTCTC-1	YRI
CGGGTCATCATGTCTT-1	YRI
CGGGTCATCCGAACGC-1	CEU
CGGTTAAAGAAACGAG-1	CEU
CGGTTAAAGAGGTACC-1	CEU
CGGTTAAAGCACCGTC-1	CEU
CGGTTAAAGCCATCGC-1	YRI
CGGTTAAAGCGCCTTG-1	CEU
CGGTTAAAGGAGTTGC-1	CEU
CGGTTAAAGTGGTCCC-1	CEU
CGGTTAAAGTTTAGGA-1	YRI
CGGTTAACAGACAAGC-1	CEU
CGGTTAACAGATCGGA-1	YRI
CGGTTAACATCAGTAC-1	CEU
CGGTTAAGTCCATCCT-1	CEU
CGGTTAAGTCTCTCTG-1	YRI
CGGTTAATCAATACCG-1	CEU
CGGTTAATCACAAACC-1	CEU
CGGTTAATCACCGTAA-1	YRI
CGGTTAATCATGCAAC-1	YRI
CGGTTAATCTGCGGCA-1	CEU
CGGTTAATCTGTTTGT-1	YRI
CGTAGCGAGAACTGTA-1	YRI
CGTAGCGAGAAGGCCT-1	YRI
CGTAGCGAGGGCTTCC-1	CEU
CGTAGCGAGTGGGATC-1	YRI
CGTAGCGCAATAAGCA-1	CEU
CGTAGCGCACAGTCGC-1	CEU
CGTAGCGGTAAGCACG-1	YRI
CGTAGCGGTCAAAGCG-1	YRI
CGTAGCGGTCTCTTTA-1	YRI
CGTAGCGGTGCGGTAA-1	CEU
CGTAGCGTCAACGGGA-1	YRI
CGTAGCGTCCGGGTGT-1	YRI
CGTAGGCCACGAAATA-1	YRI
CGTAGGCGTACAGTGG-1	CEU
CGTAGGCGTCCGTTAA-1	CEU
CGTAGGCGTCTAGCGC-1	YRI
CGTAGGCTCAACGGCC-1	YRI
CGTAGGCTCATGGTCA-1	CEU
CGTAGGCTCCAGAGGA-1	CEU
CGTAGGCTCGTTGACA-1	YRI
CGTCACTAGCCCAATT-1	CEU
CGTCACTCAAGCGCTC-1	YRI
CGTCACTCAAGTACCT-1	CEU
CGTCACTCATTTCAGG-1	YRI
CGTCACTTCAACGAAA-1	YRI
CGTCACTTCCTAGTGA-1	CEU
CGTCACTTCTGCTGCT-1	YRI
CGTCAGGAGACCACGA-1	CEU
CGTCAGGAGGAGTAGA-1	YRI
CGTCAGGCAACTTGAC-1	YRI
CGTCAGGCATCACGAT-1	YRI
CGTCAGGGTAAACCTC-1	CEU
CGTCAGGGTAAGCACG-1	YRI
CGTCAGGGTAGAGTGC-1	YRI
CGTCAGGGTGCTTCTC-1	CEU
CGTCCATAGACAATAC-1	CEU
CGTCCATAGAGCCCAA-1	YRI
CGTCCATAGATGGGTC-1	YRI
CGTCCATAGCACGCCT-1	YRI
CGTCCATAGCTCAACT-1	CEU
CGTCCATAGCTGTCTA-1	CEU
CGTCCATCAAGCTGGA-1	YRI
CGTCCATCAATCCGAT-1	CEU
CGTCCATCATTGGTAC-1	YRI
CGTCCATGTACCTACA-1	CEU
CGTCCATGTCGAAAGC-1	YRI
CGTCCATGTTTGCATG-1	YRI
CGTCCATTCAGGCCCA-1	CEU
CGTCCATTCCAAGCCG-1	YRI
CGTCCATTCCAGTATG-1	CEU
CGTCCATTCCCAAGTA-1	YRI
CGTCCATTCCTTAATC-1	YRI
CGTCCATTCGCTTAGA-1	CEU
CGTCCATTCTCCGGTT-1	CEU
CGTCCATTCTCTGAGA-1	CEU
CGTCTACAGAGGGCTT-1	YRI
CGTCTACAGCGTGTCC-1	CEU
CGTCTACAGTTATCGC-1	YRI
CGTCTACCACCTATCC-1	YRI
CGTCTACCATGCGCAC-1	CEU
CGTCTACGTGAAGGCT-1	CEU
CGTCTACGTGTGTGCC-1	YRI
CGTCTACTCACCTCGT-1	YRI
CGTCTACTCACTCCTG-1	CEU
CGTCTACTCAGCTCTC-1	CEU
CGTCTACTCCAAAGTC-1	CEU
CGTCTACTCTGTCTAT-1	YRI
CGTGAGCAGAGAACAG-1	YRI
CGTGAGCAGTCATCCA-1	YRI
CGTGAGCAGTCCCACG-1	YRI
CGTGAGCCACCTTGTC-1	YRI
CGTGAGCCATCTGGTA-1	YRI
CGTGAGCCATGTCGAT-1	CEU
CGTGAGCGTAGCAAAT-1	CEU
CGTGAGCGTGTAAGTA-1	YRI
CGTGAGCGTTACGTCA-1	YRI
CGTGAGCGTTTGGGCC-1	YRI
CGTGAGCTCACAGTAC-1	YRI
CGTGAGCTCACGGTTA-1	YRI
CGTGAGCTCATAGCAC-1	CEU
CGTGAGCTCCGAACGC-1	CEU
CGTGAGCTCTAACCGA-1	YRI
CGTGAGCTCTCAACTT-1	YRI
CGTGAGCTCTTCGGTC-1	CEU
CGTGTAAAGCGCCTCA-1	CEU
CGTGTAAAGCGGATCA-1	CEU
CGTGTAACAATAGAGT-1	YRI
CGTGTAACACCGAATT-1	CEU
CGTGTAACACCTCGTT-1	CEU
CGTGTAACACTGTCGG-1	CEU
CGTGTAACACTTGGAT-1	CEU
CGTGTAACAGCAGTTT-1	CEU
CGTGTAAGTCCCTTGT-1	CEU
CGTGTAAGTGCAACTT-1	CEU
CGTGTAAGTGTCTGAT-1	CEU
CGTGTAAGTTACGCGC-1	CEU
CGTGTAAGTTCGTTGA-1	CEU
CGTGTAATCAACACCA-1	CEU
CGTGTAATCCTATTCA-1	CEU
CGTGTAATCTTACCGC-1	CEU
CGTGTCTAGGCAATTA-1	YRI
CGTGTCTCAATCCGAT-1	YRI
CGTGTCTCACAGATTC-1	CEU
CGTGTCTCATATGCTG-1	YRI
CGTGTCTGTAGCGCTC-1	YRI
CGTGTCTGTCAGTGGA-1	YRI
CGTGTCTGTTCATGGT-1	YRI
CGTGTCTGTTCCATGA-1	CEU
CGTGTCTTCACAGGCC-1	YRI
CGTGTCTTCCTCATTA-1	CEU
CGTGTCTTCGTAGGAG-1	YRI
CGTGTCTTCTTGCCGT-1	CEU
CGTTAGAAGACAATAC-1	YRI
CGTTAGAAGTGCGTGA-1	YRI
CGTTAGAAGTGGGTTG-1	CEU
CGTTAGAAGTTCGATC-1	YRI
CGTTAGACACGCCAGT-1	YRI
CGTTAGACAGTATCTG-1	YRI
CGTTAGACATCAGTAC-1	YRI
CGTTAGAGTCGCATCG-1	YRI
CGTTAGAGTCTCATCC-1	CEU
CGTTAGAGTTGAGTTC-1	CEU
CGTTAGAGTTTAGCTG-1	YRI
CGTTAGATCACAATGC-1	YRI
CGTTAGATCGGCGCTA-1	YRI
CGTTAGATCTGTCAAG-1	YRI
CGTTAGATCTTGTATC-1	YRI
CGTTCTGAGACAAAGG-1	YRI
CGTTCTGAGATCTGAA-1	YRI
CGTTCTGAGCACAGGT-1	YRI
CGTTCTGAGCGTTTAC-1	CEU
CGTTCTGAGGAGCGTT-1	YRI
CGTTCTGCACGGCCAT-1	CEU
CGTTCTGGTAAACGCG-1	YRI
CGTTCTGGTATATGAG-1	CEU
CGTTCTGGTATCACCA-1	CEU
CGTTCTGGTCAGTGGA-1	CEU
CGTTCTGGTTCTGTTT-1	YRI
CGTTCTGTCACAGGCC-1	CEU
CGTTCTGTCCACGTGG-1	YRI
CGTTCTGTCTGGCGTG-1	YRI
CGTTGGGAGACGCAAC-1	YRI
CGTTGGGAGTCTTGCA-1	YRI
CGTTGGGCATCCGCGA-1	YRI
CGTTGGGCATCTACGA-1	CEU
CGTTGGGGTAAACGCG-1	CEU
CGTTGGGGTAGATTAG-1	CEU
CGTTGGGGTATAGGGC-1	CEU
CGTTGGGGTGGGTATG-1	YRI
CGTTGGGGTGTGGCTC-1	CEU
CGTTGGGTCACTTACT-1	CEU
CGTTGGGTCCGAATGT-1	YRI
CGTTGGGTCGACCAGC-1	YRI
CTAACTTAGACGCTTT-1	YRI
CTAACTTAGATATGCA-1	YRI
CTAACTTAGGTGCTTT-1	CEU
CTAACTTCAGACGCAA-1	CEU
CTAACTTCAGGGTATG-1	YRI
CTAACTTCATCTCGCT-1	CEU
CTAACTTCATGTCTCC-1	YRI
CTAACTTGTGAAAGAG-1	CEU
CTAACTTGTTGGAGGT-1	YRI
CTAACTTTCAGGCCCA-1	YRI
CTAACTTTCAGTTGAC-1	YRI
CTAACTTTCCACTCCA-1	CEU
CTAACTTTCCAGATCA-1	YRI
CTAACTTTCCCGGATG-1	YRI
CTAACTTTCGGTTCGG-1	YRI
CTAACTTTCTCTAAGG-1	CEU
CTAACTTTCTGCAAGT-1	YRI
CTAACTTTCTGGAGCC-1	CEU
CTAAGACAGACATAAC-1	YRI
CTAAGACAGCTCTCGG-1	CEU
CTAAGACAGGGAAACA-1	YRI
CTAAGACAGTAGTGCG-1	YRI
CTAAGACAGTGGACGT-1	CEU
CTAAGACCATTTCACT-1	YRI
CTAAGACGTCGAGTTT-1	YRI
CTAAGACGTGTCAATC-1	YRI
CTAAGACTCCAACCAA-1	YRI
CTAAGACTCCTTAATC-1	YRI
CTAAGACTCGCAGGCT-1	YRI
CTAAGACTCGGCCGAT-1	YRI
CTAAGACTCTGATTCT-1	YRI
CTAATGGAGATAGGAG-1	CEU
CTAATGGCACGCTTTC-1	CEU
CTAATGGCAGCTCGCA-1	YRI
CTAATGGGTAGGACAC-1	YRI
CTAATGGGTTATTCTC-1	CEU
CTAATGGTCAGTTCGA-1	YRI
CTAATGGTCCTATTCA-1	YRI
CTAATGGTCTCGGACG-1	CEU
CTACACCAGCGTCTAT-1	YRI
CTACACCAGGCAAAGA-1	YRI
CTACACCAGGTGCACA-1	YRI
CTACACCCACAACGTT-1	CEU
CTACACCGTTACCAGT-1	CEU
CTACACCTCAAGCCTA-1	CEU
CTACATTAGATATACG-1	YRI
CTACATTAGGCCCTCA-1	YRI
CTACATTCACAGCGTC-1	CEU
CTACATTCACCTTGTC-1	CEU
CTACATTCAGCTGTTA-1	CEU
CTACATTCAGGGTATG-1	YRI
CTACATTCAGTTCCCT-1	CEU
CTACATTCATAGGATA-1	CEU
CTACATTGTACCGGCT-1	YRI
CTACATTTCACAGTAC-1	CEU
CTACATTTCACCAGGC-1	CEU
CTACATTTCCAACCAA-1	CEU
CTACATTTCGGGAGTA-1	CEU
CTACATTTCTTGACGA-1	CEU
CTACCCAAGACAGACC-1	CEU
CTACCCAAGAGCCTAG-1	CEU
CTACCCACACGAAGCA-1	CEU
CTACCCAGTACACCGC-1	YRI
CTACCCAGTACTTGAC-1	YRI
CTACCCAGTCGCCATG-1	YRI
CTACCCAGTGTAAGTA-1	YRI
CTACCCATCATTGCCC-1	CEU
CTACCCATCCAGAAGG-1	YRI
CTACCCATCCGCAAGC-1	CEU
CTACCCATCCTACAGA-1	YRI
CTACCCATCGCCTGAG-1	YRI
CTACCCATCTCTAGGA-1	YRI
CTACGTCAGATATACG-1	CEU
CTACGTCCACAGAGGT-1	YRI
CTACGTCCATGCCTAA-1	YRI
CTACGTCGTCGACTAT-1	YRI
CTACGTCGTTCACGGC-1	YRI
CTACGTCTCACCTTAT-1	YRI
CTACGTCTCTACCAGA-1	CEU
CTACGTCTCTCGCTTG-1	YRI
CTAGAGTAGGACAGCT-1	YRI
CTAGAGTCAAGGACAC-1	CEU
CTAGAGTCACTAGTAC-1	YRI
CTAGAGTGTAGCGTGA-1	YRI
CTAGAGTGTATCGCAT-1	YRI
CTAGAGTGTCCGAATT-1	CEU
CTAGAGTGTTGCCTCT-1	CEU
CTAGAGTTCGGCGCTA-1	YRI
CTAGCCTAGACGCACA-1	CEU
CTAGCCTAGCCAGTAG-1	YRI
CTAGCCTAGGGCTTGA-1	YRI
CTAGCCTCAAGTCATC-1	YRI
CTAGCCTCAAGTCTAC-1	YRI
CTAGCCTCATGCAACT-1	CEU
CTAGCCTGTAACGTTC-1	YRI
CTAGCCTGTGGGTCAA-1	CEU
CTAGCCTTCTCGAGTA-1	YRI
CTAGTGAAGCGACGTA-1	YRI
CTAGTGACAGACACTT-1	YRI
CTAGTGACAGCTCGCA-1	YRI
CTAGTGACATTCTTAC-1	YRI
CTAGTGAGTAAGTGTA-1	CEU
CTAGTGAGTGACGCCT-1	CEU
CTAGTGATCCGCAAGC-1	CEU
CTAGTGATCCTAGGGC-1	YRI
CTAGTGATCGCATGGC-1	YRI
CTAGTGATCGCCATAA-1	YRI
CTAGTGATCTACTATC-1	CEU
CTCACACAGACAATAC-1	YRI
CTCACACAGATCTGCT-1	YRI
CTCACACAGCCTTGAT-1	YRI
CTCACACAGGATTCGG-1	CEU
CTCACACAGGTTCCTA-1	CEU
CTCACACCAACGATCT-1	YRI
CTCACACCACGGTAGA-1	YRI
CTCACACCAGGGTTAG-1	CEU
CTCACACCATGCCACG-1	YRI
CTCACACGTACATGTC-1	YRI
CTCACACGTAGCGTCC-1	CEU
CTCACACGTCACTTCC-1	YRI
CTCACACGTTGAGTTC-1	YRI
CTCACACTCAGCCTAA-1	CEU
CTCACACTCATGTGGT-1	CEU
CTCACACTCCTTGGTC-1	YRI
CTCACACTCGGTCTAA-1	CEU
CTCAGAAAGTAAGTAC-1	YRI
CTCAGAACATGCATGT-1	CEU
CTCAGAAGTCCAGTGC-1	YRI
CTCAGAAGTCTGATCA-1	YRI
CTCAGAATCAACTCTT-1	YRI
CTCAGAATCCATGAGT-1	CEU
CTCAGAATCCGCGGTA-1	YRI
CTCAGAATCTTTACAC-1	YRI
CTCATTAAGACACTAA-1	YRI
CTCATTAAGACTGTAA-1	CEU
CTCATTAAGCGATGAC-1	YRI
CTCATTAAGTGAAGAG-1	YRI
CTCATTACAAGCTGTT-1	CEU
CTCATTACATGATCCA-1	YRI
CTCATTAGTACTTGAC-1	YRI
CTCATTATCAGGCCCA-1	YRI
CTCCTAGAGAGACTTA-1	YRI
CTCCTAGAGCAGACTG-1	CEU
CTCCTAGAGGACACCA-1	YRI
CTCCTAGAGGGATCTG-1	YRI
CTCCTAGCAAGTCATC-1	CEU
CTCCTAGCACATCTTT-1	CEU
CTCCTAGCACTTAACG-1	YRI
CTCCTAGCAGGTCTCG-1	YRI
CTCCTAGCATCCTTGC-1	YRI
CTCCTAGTCGTGGTCG-1	CEU
CTCCTAGTCTGCTGTC-1	CEU
CTCGAAAAGACCGGAT-1	CEU
CTCGAAAAGAGGGCTT-1	YRI
CTCGAAAAGCTTATCG-1	CEU
CTCGAAAAGTACACCT-1	CEU
CTCGAAAAGTACGCGA-1	YRI
CTCGAAAAGTGACATA-1	CEU
CTCGAAACAAGCGTAG-1	YRI
CTCGAAACAGACGCAA-1	CEU
CTCGAAACATCACAAC-1	CEU
CTCGAAAGTAATCACC-1	YRI
CTCGAAAGTACGCTGC-1	CEU
CTCGAAAGTCTAGTGT-1	CEU
CTCGAAAGTGTAACGG-1	YRI
CTCGAAATCAGCTGGC-1	YRI
CTCGAAATCATGTAGC-1	YRI
CTCGAAATCCGTCATC-1	YRI
CTCGAGGAGAGGACGG-1	YRI
CTCGAGGAGTGAAGTT-1	YRI
CTCGAGGAGTGTGGCA-1	YRI
CTCGAGGCACCTGGTG-1	CEU
CTCGAGGGTCAGCTAT-1	YRI
CTCGAGGGTGACAAAT-1	CEU
CTCGAGGGTTGACGTT-1	YRI
CTCGAGGTCCTGCAGG-1	YRI
CTCGGAGAGATGTGTA-1	CEU
CTCGGAGAGGCTCATT-1	YRI
CTCGGAGAGGGCTCTC-1	YRI
CTCGGAGAGGTGCTTT-1	YRI
CTCGGAGCACGTCAGC-1	YRI
CTCGGAGCAGCTTCGG-1	YRI
CTCGGAGCAGTCGATT-1	YRI
CTCGGAGCATGCTAGT-1	YRI
CTCGGAGGTCCGAGTC-1	YRI
CTCGGAGGTTCGCTAA-1	CEU
CTCGGAGGTTTCGCTC-1	CEU
CTCGGAGTCCAGGGCT-1	CEU
CTCGGAGTCCCTAATT-1	YRI
CTCGGAGTCCGCGCAA-1	YRI
CTCGGAGTCGAACTGT-1	CEU
CTCGGAGTCTAGAGTC-1	YRI
CTCGGGAAGCCGATTT-1	CEU
CTCGGGAAGCTGCAAG-1	YRI
CTCGGGAAGTACGACG-1	CEU
CTCGGGACAAGCCGCT-1	YRI
CTCGGGACACGCCAGT-1	YRI
CTCGGGACACTACAGT-1	YRI
CTCGGGACATACTCTT-1	YRI
CTCGGGACATCACGAT-1	YRI
CTCGGGACATGAAGTA-1	YRI
CTCGGGACATTGGGCC-1	CEU
CTCGGGAGTCCCTACT-1	YRI
CTCGGGAGTGGAAAGA-1	CEU
CTCGGGAGTTAGGGTG-1	YRI
CTCGGGATCACCTTAT-1	YRI
CTCGGGATCCGCAAGC-1	YRI
CTCGGGATCGGAATCT-1	YRI
CTCGGGATCTCCGGTT-1	CEU
CTCGTACAGGCGACAT-1	CEU
CTCGTACCAAGCCATT-1	CEU
CTCGTACCACACCGCA-1	YRI
CTCGTACCATGCTGGC-1	YRI
CTCGTACCATTGGTAC-1	YRI
CTCGTACGTGCTAGCC-1	CEU
CTCGTACGTTGAGGTG-1	CEU
CTCGTACTCAACCAAC-1	YRI
CTCGTACTCAATCACG-1	YRI
CTCGTACTCAGCTTAG-1	CEU
CTCGTACTCATTCACT-1	YRI
CTCGTACTCCAAAGTC-1	YRI
CTCGTACTCCTGCCAT-1	YRI
CTCGTACTCGTTGCCT-1	YRI
CTCGTACTCTTTCCTC-1	CEU
CTCGTCAAGCACGCCT-1	YRI
CTCGTCAAGCGGATCA-1	YRI
CTCGTCAAGTCAATAG-1	YRI
CTCGTCACAATCTACG-1	CEU
CTCGTCACACCGTTGG-1	YRI
CTCGTCAGTAGCAAAT-1	YRI
CTCGTCAGTGAGGGAG-1	CEU
CTCGTCAGTTCCACGG-1	YRI
CTCGTCAGTTGGGACA-1	YRI
CTCGTCATCGGTCTAA-1	YRI
CTCTAATAGAGTCTGG-1	CEU
CTCTAATAGATGCCAG-1	YRI
CTCTAATAGCGCTCCA-1	CEU
CTCTAATAGCGTCAAG-1	CEU
CTCTAATAGCTGTCTA-1	YRI
CTCTAATAGTCATGCT-1	CEU
CTCTAATCAATCGGTT-1	YRI
CTCTAATGTCTCCACT-1	YRI
CTCTAATGTCTGGAGA-1	CEU
CTCTAATTCATTGCGA-1	CEU
CTCTAATTCCAAGTAC-1	CEU
CTCTAATTCCATGCTC-1	CEU
CTCTACGAGAACTCGG-1	YRI
CTCTACGAGAGTACCG-1	CEU
CTCTACGAGCCCAACC-1	YRI
CTCTACGAGGATGTAT-1	CEU
CTCTACGAGTCACGCC-1	YRI
CTCTACGAGTTACGGG-1	CEU
CTCTACGCAATCACAC-1	YRI
CTCTACGGTATGGTTC-1	YRI
CTCTACGGTCCCGACA-1	YRI
CTCTACGGTGAGCGAT-1	YRI
CTCTACGGTGGTGTAG-1	CEU
CTCTACGTCATCACCC-1	YRI
CTCTACGTCTCTTATG-1	CEU
CTCTACGTCTGCTTGC-1	YRI
CTCTGGTCAAGCCTAT-1	YRI
CTCTGGTCAAGTTCTG-1	YRI
CTCTGGTCACTCAGGC-1	YRI
CTCTGGTCAGGTCGTC-1	YRI
CTCTGGTCATCCAACA-1	YRI
CTCTGGTCATCTGGTA-1	YRI
CTCTGGTGTCAAAGAT-1	YRI
CTCTGGTGTCAATACC-1	YRI
CTCTGGTGTCTCGTTC-1	YRI
CTCTGGTTCAAACAAG-1	CEU
CTCTGGTTCAAACGGG-1	YRI
CTCTGGTTCAATCACG-1	CEU
CTCTGGTTCACTTCAT-1	YRI
CTGAAACAGCACACAG-1	YRI
CTGAAACAGTAGCCGA-1	CEU
CTGAAACAGTGGTCCC-1	YRI
CTGAAACCAAGCTGGA-1	CEU
CTGAAACCAAGGACTG-1	YRI
CTGAAACCAAGGTTCT-1	YRI
CTGAAACCACAACGCC-1	YRI
CTGAAACCACCAGCAC-1	YRI
CTGAAACGTATCGCAT-1	CEU
CTGAAACGTCGAACAG-1	CEU
CTGAAACGTCTCTTTA-1	YRI
CTGAAACGTGTGCCTG-1	CEU
CTGAAACGTTCCACAA-1	YRI
CTGAAACTCGTGGGAA-1	YRI
CTGAAACTCTGCAAGT-1	YRI
CTGAAGTAGTCCCACG-1	YRI
CTGAAGTCACGGATAG-1	YRI
CTGAAGTCACGGTAGA-1	YRI
CTGAAGTGTATTACCG-1	CEU
CTGAAGTGTGTGTGCC-1	YRI
CTGAAGTGTGTTCGAT-1	YRI
CTGATAGAGAATGTGT-1	CEU
CTGATAGAGAATGTTG-1	YRI
CTGATAGAGAGGGCTT-1	CEU
CTGATAGCACCGAATT-1	CEU
CTGATAGCACCGGAAA-1	CEU
CTGATAGGTAAGTAGT-1	YRI
CTGATAGGTAGAGCTG-1	YRI
CTGATAGGTGATAAAC-1	YRI
CTGATAGTCAGTTAGC-1	YRI
CTGATAGTCCACGTTC-1	YRI
CTGATAGTCCTAGAAC-1	CEU
CTGATAGTCCTTTCGG-1	YRI
CTGATAGTCGCGATCG-1	YRI
CTGATAGTCGCTGATA-1	YRI
CTGATAGTCTACTATC-1	YRI
CTGATAGTCTATCCTA-1	YRI
CTGATAGTCTCCAACC-1	YRI
CTGATAGTCTTCGAGA-1	CEU
CTGATCCAGTATGACA-1	CEU
CTGATCCCAGACAAAT-1	YRI
CTGATCCGTAAGTAGT-1	YRI
CTGATCCGTCAAAGAT-1	CEU
CTGATCCGTGTTTGTG-1	CEU
CTGATCCGTTAAGACA-1	YRI
CTGATCCTCACGACTA-1	CEU
CTGATCCTCCTCATTA-1	YRI
CTGCCTAAGATGCCAG-1	CEU
CTGCCTACAAGCCATT-1	YRI
CTGCCTACAGGGTACA-1	YRI
CTGCCTACATACTCTT-1	YRI
CTGCCTACATTCGACA-1	YRI
CTGCCTAGTAGCGTAG-1	CEU
CTGCCTAGTCACCCAG-1	YRI
CTGCCTAGTCAGATAA-1	YRI
CTGCCTAGTCGAGTTT-1	YRI
CTGCCTAGTCTTCGTC-1	CEU
CTGCCTAGTGGCTCCA-1	YRI
CTGCCTAGTTTAAGCC-1	CEU
CTGCCTATCAACCAAC-1	YRI
CTGCCTATCCAGTATG-1	YRI
CTGCCTATCGCCTGTT-1	CEU
CTGCCTATCGCTGATA-1	YRI
CTGCGGAAGCGCCTTG-1	YRI
CTGCGGAAGGAGCGAG-1	CEU
CTGCGGAAGGCGACAT-1	CEU
CTGCGGAAGGTGTGGT-1	YRI
CTGCGGACAATGTAAG-1	CEU
CTGCGGACACCGGAAA-1	CEU
CTGCGGACACGGACAA-1	YRI
CTGCGGACATGCTAGT-1	YRI
CTGCGGAGTCTGCGGT-1	YRI
CTGCGGATCATGTCTT-1	YRI
CTGCGGATCCAATGGT-1	YRI
CTGCGGATCGCTAGCG-1	YRI
CTGCGGATCGTTACAG-1	YRI
CTGCGGATCTGGTTCC-1	YRI
CTGCTGTAGCCGATTT-1	CEU
CTGCTGTAGTGGTAGC-1	YRI
CTGCTGTCAGGTGGAT-1	YRI
CTGCTGTGTATCGCAT-1	YRI
CTGCTGTGTATGGTTC-1	YRI
CTGCTGTGTGTTCTTT-1	YRI
CTGCTGTTCCACGACG-1	YRI
CTGCTGTTCCCTTGCA-1	CEU
CTGCTGTTCCTTGGTC-1	YRI
CTGGTCTAGAGCTGGT-1	YRI
CTGGTCTAGATGTCGG-1	YRI
CTGGTCTAGCCCGAAA-1	CEU
CTGGTCTAGTGTTGAA-1	YRI
CTGGTCTGTACTTGAC-1	YRI
CTGGTCTGTCATCGGC-1	CEU
CTGGTCTTCCTCAACC-1	YRI
CTGGTCTTCGGGAGTA-1	YRI
CTGGTCTTCTATCGCC-1	YRI
CTGGTCTTCTCCAGGG-1	YRI
CTGTGCTAGAAGAAGC-1	CEU
CTGTGCTAGTGAAGAG-1	YRI
CTGTGCTCAGGTGCCT-1	CEU
CTGTGCTCAGTTTACG-1	CEU
CTGTGCTCATGTAAGA-1	CEU
CTGTGCTCATTTCACT-1	CEU
CTGTGCTGTAAGTGGC-1	CEU
CTGTGCTGTAATAGCA-1	YRI
CTGTGCTGTTGCGCAC-1	CEU
CTGTGCTTCACAGGCC-1	CEU
CTGTGCTTCCATGAAC-1	YRI
CTGTGCTTCTGCTGCT-1	CEU
CTGTTTAAGAGCCCAA-1	YRI
CTGTTTAAGTATTGGA-1	YRI
CTGTTTACAAGCTGGA-1	CEU
CTGTTTACACCCAGTG-1	YRI
CTGTTTACATCCAACA-1	CEU
CTGTTTACATGGTAGG-1	CEU
CTGTTTAGTTAAGACA-1	YRI
CTGTTTATCACTCTTA-1	YRI
CTTAACTAGAAGAAGC-1	YRI
CTTAACTAGAGTACAT-1	CEU
CTTAACTAGATGCCAG-1	YRI
CTTAACTAGCTATGCT-1	CEU
CTTAACTAGGCGATAC-1	YRI
CTTAACTAGTGGTAAT-1	YRI
CTTAACTCAGCTCGAC-1	CEU
CTTAACTCATGAAGTA-1	CEU
CTTAACTCATGTCTCC-1	CEU
CTTAACTGTCTCACCT-1	YRI
CTTAACTGTGCGATAG-1	YRI
CTTAACTTCACTCTTA-1	YRI
CTTAACTTCATGCAAC-1	CEU
CTTAACTTCCAAGTAC-1	YRI
CTTAACTTCTACGAGT-1	CEU
CTTAACTTCTGTCAAG-1	YRI
CTTACCGAGCCCGAAA-1	YRI
CTTACCGAGGCCCTCA-1	CEU
CTTACCGAGTAACCCT-1	YRI
CTTACCGCACCGGAAA-1	CEU
CTTACCGGTACGCACC-1	CEU
CTTACCGGTCAGAAGC-1	YRI
CTTACCGGTCAGTGGA-1	YRI
CTTACCGGTCCCGACA-1	YRI
CTTACCGTCAAAGACA-1	YRI
CTTACCGTCAGGTAAA-1	YRI
CTTACCGTCCCGACTT-1	CEU
CTTACCGTCCGAACGC-1	CEU
CTTACCGTCCGAAGAG-1	YRI
CTTAGGAAGAAACGCC-1	YRI
CTTAGGAAGATGCGAC-1	CEU
CTTAGGAAGCCATCGC-1	YRI
CTTAGGACAAGCCGCT-1	CEU
CTTAGGAGTATATGAG-1	YRI
CTTAGGAGTCCCGACA-1	CEU
CTTAGGAGTCTGCAAT-1	YRI
CTTAGGAGTGAGTATA-1	CEU
CTTAGGAGTGCTGTAT-1	CEU
CTTAGGAGTGTGACCC-1	YRI
CTTAGGATCGGATGTT-1	CEU
CTTAGGATCTAACCGA-1	YRI
CTTAGGATCTCGGACG-1	CEU
CTTCTCTAGAATTCCC-1	YRI
CTTCTCTAGAGACTTA-1	YRI
CTTCTCTAGCGAGAAA-1	YRI
CTTCTCTAGGCAATTA-1	CEU
CTTCTCTAGTACATGA-1	CEU
CTTCTCTAGTCCATAC-1	CEU
CTTCTCTAGTGTGAAT-1	YRI
CTTCTCTCAGGCTGAA-1	YRI
CTTCTCTGTCGCGTGT-1	YRI
CTTCTCTGTTACAGAA-1	YRI
CTTCTCTTCACCCTCA-1	CEU
CTTGGCTAGCAGATCG-1	YRI
CTTGGCTAGCTAACTC-1	YRI
CTTGGCTAGGACAGCT-1	YRI
CTTGGCTAGGCATGGT-1	CEU
CTTGGCTAGTGATCGG-1	CEU
CTTGGCTCAAGTTCTG-1	YRI
CTTGGCTCACTTAACG-1	CEU
CTTGGCTCATCCCATC-1	YRI
CTTGGCTCATGCCACG-1	YRI
CTTGGCTCATGGAATA-1	CEU
CTTGGCTGTGCGATAG-1	YRI
CTTGGCTGTTCGTGAT-1	YRI
CTTTGCGAGTGCCATT-1	YRI
CTTTGCGCAGCTATTG-1	YRI
CTTTGCGCATATACGC-1	CEU
CTTTGCGCATCGGGTC-1	CEU
CTTTGCGCATCTCGCT-1	CEU
CTTTGCGGTACCATCA-1	CEU
CTTTGCGGTCTTCGTC-1	YRI
CTTTGCGGTGGTAACG-1	YRI
CTTTGCGGTGGTCTCG-1	YRI
CTTTGCGGTGTGACGA-1	YRI
CTTTGCGGTTAAGACA-1	YRI
CTTTGCGGTTGGTGGA-1	YRI
CTTTGCGGTTGGTTTG-1	CEU
CTTTGCGTCACCTTAT-1	YRI
CTTTGCGTCAGTTAGC-1	CEU
GAAACTCAGAAGGTGA-1	YRI
GAAACTCAGAGCTGCA-1	YRI
GAAACTCAGCGTGTCC-1	CEU
GAAACTCCAGCTGCTG-1	CEU
GAAACTCGTCATGCAT-1	YRI
GAAACTCTCACCCGAG-1	YRI
GAAACTCTCTGACCTC-1	YRI
GAAACTCTCTGTACGA-1	YRI
GAAATGAAGCCACCTG-1	CEU
GAAATGAAGCCAGTAG-1	YRI
GAAATGAAGCGATGAC-1	YRI
GAAATGAAGGCCCGTT-1	YRI
GAAATGAAGTGTTAGA-1	YRI
GAAATGACAGTAGAGC-1	CEU
GAAATGAGTTCCAACA-1	YRI
GAAATGATCAGAAATG-1	CEU
GAAATGATCATGTGGT-1	YRI
GAAATGATCGGCATCG-1	YRI
GAAATGATCTAACCGA-1	CEU
GAAATGATCTGCAAGT-1	CEU
GAAATGATCTTACCTA-1	CEU
GAACATCAGCCATCGC-1	CEU
GAACATCAGCCCTAAT-1	YRI
GAACATCAGGCTCATT-1	YRI
GAACATCCACGTCTCT-1	YRI
GAACATCCATCTCGCT-1	CEU
GAACATCGTCCGAGTC-1	YRI
GAACATCGTGAAGGCT-1	CEU
GAACATCGTTGAGGTG-1	CEU
GAACATCTCCTTTACA-1	YRI
GAACATCTCTGTCAAG-1	YRI
GAACATCTCTTCTGGC-1	CEU
GAACCTAAGAAGGCCT-1	YRI
GAACCTAAGAGCAATT-1	YRI
GAACCTAAGCTCAACT-1	YRI
GAACCTACAGATCCAT-1	CEU
GAACCTACATAAGACA-1	YRI
GAACCTACATTTGCTT-1	YRI
GAACCTAGTACGACCC-1	CEU
GAACCTAGTCTAGAGG-1	YRI
GAACCTAGTTCCACAA-1	CEU
GAACCTATCACCAGGC-1	YRI
GAACCTATCACCTCGT-1	YRI
GAACCTATCCACGACG-1	CEU
GAACCTATCGGCGCTA-1	CEU
GAACGGAAGAAGATTC-1	CEU
GAACGGAAGAGGGATA-1	YRI
GAACGGAAGCAGGTCA-1	YRI
GAACGGAAGCCGATTT-1	CEU
GAACGGAAGTATGACA-1	YRI
GAACGGACAAACGTGG-1	CEU
GAACGGACATACTACG-1	YRI
GAACGGAGTGTTTGTG-1	YRI
GAACGGATCAGGTTCA-1	CEU
GAACGGATCCAGAGGA-1	CEU
GAACGGATCGTGGGAA-1	YRI
GAACGGATCTCCAACC-1	YRI
GAACGGATCTGTCTAT-1	YRI
GAAGCAGAGAAACCGC-1	CEU
GAAGCAGAGACACGAC-1	CEU
GAAGCAGAGACTGTAA-1	YRI
GAAGCAGAGCCACTAT-1	YRI
GAAGCAGAGCGATTCT-1	CEU
GAAGCAGAGCTGTCTA-1	CEU
GAAGCAGAGGCGACAT-1	YRI
GAAGCAGAGTAGGTGC-1	YRI
GAAGCAGAGTTGAGTA-1	CEU
GAAGCAGCAAGCTGAG-1	YRI
GAAGCAGCAATCTGCA-1	CEU
GAAGCAGCATCCAACA-1	CEU
GAAGCAGCATGACGGA-1	CEU
GAAGCAGGTGAGCGAT-1	YRI
GAAGCAGGTGTAACGG-1	CEU
GAAGCAGGTTGGACCC-1	YRI
GAAGCAGTCTCAAGTG-1	YRI
GAATAAGAGACCTAGG-1	YRI
GAATAAGAGCACCGCT-1	CEU
GAATAAGAGCTGCCCA-1	CEU
GAATAAGAGGTAGCTG-1	0
GAATAAGAGTCCTCCT-1	YRI
GAATAAGAGTCGTACT-1	CEU
GAATAAGCACCCATGG-1	CEU
GAATAAGCATTCCTGC-1	YRI
GAATAAGGTATATGAG-1	CEU
GAATAAGGTCGGATCC-1	CEU
GAATAAGGTGATAAAC-1	CEU
GAATAAGGTTACGCGC-1	YRI
GAATGAAAGACCCACC-1	YRI
GAATGAAAGAGGACGG-1	CEU
GAATGAAAGGGTATCG-1	CEU
GAATGAAAGGTGTTAA-1	CEU
GAATGAAAGTACGTAA-1	YRI
GAATGAAAGTAGCCGA-1	YRI
GAATGAAAGTGTGGCA-1	YRI
GAATGAACAAAGCAAT-1	YRI
GAATGAACAAAGCGGT-1	YRI
GAATGAACAAGTTCTG-1	CEU
GAATGAACAGACAAAT-1	CEU
GAATGAACAGCTTCGG-1	YRI
GAATGAACATCGATGT-1	CEU
GAATGAACATCGGTTA-1	CEU
GAATGAAGTGGCCCTA-1	YRI
GAATGAAGTTTGCATG-1	YRI
GAATGAATCACCGGGT-1	CEU
GAATGAATCCTCATTA-1	CEU
GAATGAATCCTCCTAG-1	YRI
GAATGAATCTTCCTTC-1	YRI
GACACGCAGAAGCCCA-1	CEU
GACACGCAGGCAGGTT-1	YRI
GACACGCAGGCGACAT-1	YRI
GACACGCAGGCTCTTA-1	YRI
GACACGCAGTGAACGC-1	CEU
GACACGCCACCTCGTT-1	YRI
GACACGCCATGGATGG-1	YRI
GACACGCGTCGAATCT-1	YRI
GACACGCGTGACAAAT-1	YRI
GACACGCGTGCTTCTC-1	CEU
GACACGCTCACAGTAC-1	YRI
GACACGCTCAGATAAG-1	YRI
GACAGAGAGCCAGGAT-1	YRI
GACAGAGAGGACATTA-1	CEU
GACAGAGAGGCCATAG-1	YRI
GACAGAGAGGTGCAAC-1	YRI
GACAGAGCAAAGGCGT-1	YRI
GACAGAGCACTTGGAT-1	YRI
GACAGAGCATTCTTAC-1	CEU
GACAGAGGTAAGAGGA-1	CEU
GACAGAGGTAAGCACG-1	YRI
GACAGAGTCGTATCAG-1	YRI
GACAGAGTCTAGAGTC-1	CEU
GACAGAGTCTCAACTT-1	CEU
GACCAATAGAAACGCC-1	YRI
GACCAATAGGGATGGG-1	YRI
GACCAATAGTGTTGAA-1	CEU
GACCAATCAACTGCGC-1	YRI
GACCAATCAAGACGTG-1	CEU
GACCAATCAAGCGCTC-1	CEU
GACCAATCAGCTCGCA-1	CEU
GACCAATCATAGAAAC-1	CEU
GACCAATGTCTACCTC-1	YRI
GACCAATTCATGTAGC-1	CEU
GACCAATTCCATGCTC-1	CEU
GACCAATTCCCAACGG-1	YRI
GACCAATTCCCAGGTG-1	CEU
GACCAATTCGAGGTAG-1	YRI
GACCAATTCGGTTAAC-1	CEU
GACCAATTCGTTTATC-1	YRI
GACCAATTCTTCCTTC-1	CEU
GACCTGGAGAAACCTA-1	YRI
GACCTGGAGAGTAATC-1	CEU
GACCTGGAGAGTCTGG-1	YRI
GACCTGGAGGCGTACA-1	CEU
GACCTGGGTACTTGAC-1	YRI
GACCTGGGTAGATTAG-1	YRI
GACCTGGGTAGCTCCG-1	YRI
GACCTGGGTGACTACT-1	YRI
GACCTGGTCACTCCTG-1	YRI
GACGCGTAGAAGATTC-1	YRI
GACGCGTAGCCTATGT-1	YRI
GACGCGTAGTGAACGC-1	YRI
GACGCGTAGTGACATA-1	CEU
GACGCGTCAAGGCTCC-1	YRI
GACGCGTCACTACAGT-1	YRI
GACGCGTCAGTACACT-1	CEU
GACGCGTCATGGATGG-1	CEU
GACGCGTCATTCCTGC-1	YRI
GACGCGTGTATAAACG-1	CEU
GACGCGTGTCAGATAA-1	YRI
GACGCGTGTGCAACGA-1	CEU
GACGCGTGTGGCCCTA-1	YRI
GACGCGTGTTCGCGAC-1	CEU
GACGCGTTCAGCCTAA-1	CEU
GACGCGTTCCGCAAGC-1	YRI
GACGCGTTCCGTACAA-1	CEU
GACGCGTTCGGTCTAA-1	YRI
GACGGCTAGAACAATC-1	YRI
GACGGCTAGCTAAGAT-1	YRI
GACGGCTAGGGATACC-1	YRI
GACGGCTAGTATGACA-1	CEU
GACGGCTCACATAACC-1	YRI
GACGGCTCAGCTGGCT-1	CEU
GACGGCTCAGTCCTTC-1	YRI
GACGGCTCATGCTGGC-1	CEU
GACGGCTGTAAAGTCA-1	YRI
GACGGCTGTCAAACTC-1	YRI
GACGGCTTCAAGCCTA-1	YRI
GACGGCTTCACTCTTA-1	CEU
GACGGCTTCTGCCAGG-1	CEU
GACGTGCAGTCTTGCA-1	CEU
GACGTGCCAAACAACA-1	YRI
GACGTGCCATGGTTGT-1	CEU
GACGTGCGTATAAACG-1	YRI
GACGTGCGTGTCCTCT-1	YRI
GACGTTAAGGCTAGCA-1	YRI
GACGTTAAGGGTGTGT-1	CEU
GACGTTAAGGTGGGTT-1	YRI
GACGTTAGTACAGACG-1	CEU
GACGTTAGTCAAAGAT-1	YRI
GACGTTAGTGTTTGGT-1	YRI
GACGTTATCAGAGACG-1	YRI
GACGTTATCGGCCGAT-1	YRI
GACTAACAGAATTGTG-1	YRI
GACTAACAGATTACCC-1	YRI
GACTAACAGGCGTACA-1	CEU
GACTAACAGTCCAGGA-1	YRI
GACTAACCACGGCTAC-1	CEU
GACTAACCATCACAAC-1	CEU
GACTAACCATCTCGCT-1	CEU
GACTAACGTACACCGC-1	YRI
GACTAACGTCTTGATG-1	CEU
GACTAACGTGATGATA-1	YRI
GACTAACGTTCTGTTT-1	YRI
GACTAACTCATTGCGA-1	CEU
GACTAACTCCAAACAC-1	CEU
GACTAACTCGTTACGA-1	CEU
GACTAACTCGTTGCCT-1	CEU
GACTACAAGGCTCTTA-1	YRI
GACTACAAGTTACCCA-1	YRI
GACTACACAACACCTA-1	CEU
GACTACACAAGTTAAG-1	CEU
GACTACACACGTCAGC-1	CEU
GACTACAGTCCTCCAT-1	YRI
GACTACAGTCTGCCAG-1	YRI
GACTACAGTGTGACGA-1	CEU
GACTACAGTTATTCTC-1	CEU
GACTACATCACCATAG-1	YRI
GACTACATCGATAGAA-1	CEU
GACTACATCTGCCAGG-1	YRI
GACTGCGAGATGAGAG-1	YRI
GACTGCGAGGCATTGG-1	YRI
GACTGCGAGTCTCAAC-1	YRI
GACTGCGCAATCACAC-1	CEU
GACTGCGCATTCCTCG-1	CEU
GACTGCGGTCGCATAT-1	YRI
GACTGCGTCAATACCG-1	YRI
GACTGCGTCGCAGGCT-1	YRI
GAGCAGAAGAGCTGGT-1	YRI
GAGCAGAAGCGCCTTG-1	YRI
GAGCAGAAGGCCATAG-1	CEU
GAGCAGAAGGGCTTGA-1	YRI
GAGCAGACACCAGATT-1	YRI
GAGCAGACATCGTCGG-1	YRI
GAGCAGACATGAAGTA-1	YRI
GAGCAGAGTCTAGAGG-1	YRI
GAGCAGAGTTTAGGAA-1	CEU
GAGCAGATCACCTTAT-1	CEU
GAGCAGATCCTAAGTG-1	CEU
GAGCAGATCGCATGAT-1	CEU
GAGCAGATCGGTTAAC-1	YRI
GAGCAGATCTCTGTCG-1	YRI
GAGGTGAAGACAGACC-1	YRI
GAGGTGAAGACTGGGT-1	YRI
GAGGTGAAGGCCCTTG-1	CEU
GAGGTGACAGCCTGTG-1	CEU
GAGGTGACATTAACCG-1	CEU
GAGGTGAGTAATCACC-1	YRI
GAGGTGAGTACTCGCG-1	CEU
GAGGTGAGTCCTGCTT-1	CEU
GAGGTGAGTGTCTGAT-1	YRI
GAGGTGATCAAACAAG-1	YRI
GAGGTGATCAGGATCT-1	YRI
GAGGTGATCCCAGGTG-1	CEU
GAGGTGATCCGTAGTA-1	YRI
GAGGTGATCGTCACGG-1	YRI
GAGGTGATCTATCGCC-1	YRI
GAGTCCGAGACAATAC-1	YRI
GAGTCCGAGGAACTGC-1	CEU
GAGTCCGAGTGATCGG-1	YRI
GAGTCCGAGTGCTGCC-1	YRI
GAGTCCGCAATTCCTT-1	YRI
GAGTCCGGTATAAACG-1	CEU
GAGTCCGGTATAGGTA-1	YRI
GAGTCCGGTGCCTTGG-1	CEU
GAGTCCGTCACCGTAA-1	YRI
GAGTCCGTCACGCGGT-1	YRI
GAGTCCGTCAGCATGT-1	YRI
GAGTCCGTCATGCTCC-1	YRI
GATCAGTAGAGATGAG-1	YRI
GATCAGTAGCATCATC-1	YRI
GATCAGTAGGACTGGT-1	CEU
GATCAGTAGGCACATG-1	YRI
GATCAGTAGGTGCAAC-1	CEU
GATCAGTAGTGGTCCC-1	YRI
GATCAGTCAGCCTGTG-1	YRI
GATCAGTCATAGAAAC-1	CEU
GATCAGTGTACTTAGC-1	YRI
GATCAGTGTATCACCA-1	YRI
GATCAGTGTATTCTCT-1	CEU
GATCAGTGTCAAGCGA-1	YRI
GATCAGTGTCTTCGTC-1	YRI
GATCAGTGTTGCGTTA-1	YRI
GATCAGTTCGGTTCGG-1	CEU
GATCAGTTCTTCGGTC-1	YRI
GATCGATAGATCACGG-1	YRI
GATCGATAGGTCGGAT-1	YRI
GATCGATAGTGTTTGC-1	YRI
GATCGATCAAGGACAC-1	YRI
GATCGATCACAACGTT-1	YRI
GATCGATCACGAGAGT-1	CEU
GATCGATCACGCCAGT-1	YRI
GATCGATCATATACGC-1	YRI
GATCGATCATATGCTG-1	CEU
GATCGATCATCCAACA-1	CEU
GATCGATCATCGTCGG-1	CEU
GATCGATCATTCCTCG-1	CEU
GATCGATGTCCATCCT-1	YRI
GATCGATGTCCGAAGA-1	YRI
GATCGATGTCTAACGT-1	CEU
GATCGATGTGCTCTTC-1	YRI
GATCGATGTTCCTCCA-1	CEU
GATCGATTCCAAGTAC-1	YRI
GATCGATTCCCGACTT-1	CEU
GATCGATTCCGCGCAA-1	YRI
GATCGATTCTAAGCCA-1	CEU
GATCGCGAGCCCAGCT-1	YRI
GATCGCGAGTTATCGC-1	YRI
GATCGCGCACCCATTC-1	YRI
GATCGCGCATGCCTTC-1	YRI
GATCGCGGTCCGTTAA-1	YRI
GATCGCGGTCTTGCGG-1	CEU
GATCGCGTCATTTGGG-1	CEU
GATCGCGTCCTACAGA-1	YRI
GATCGCGTCTTCATGT-1	CEU
GATCGTAAGATCCCAT-1	YRI
GATCGTAAGCATCATC-1	CEU
GATCGTAAGGGTTTCT-1	YRI
GATCGTAAGTGAAGTT-1	CEU
GATCGTACAATGCCAT-1	YRI
GATCGTACACTCTGTC-1	YRI
GATCGTACAGGTCGTC-1	CEU
GATCGTACATACTCTT-1	YRI
GATCGTAGTCCATCCT-1	YRI
GATCGTAGTCGATTGT-1	CEU
GATCGTATCAAGAAGT-1	YRI
GATCGTATCATCATTC-1	0
GATCGTATCATGTCCC-1	YRI
GATCGTATCTCTAGGA-1	YRI
GATCTAGAGAGGGCTT-1	YRI
GATCTAGAGGACCACA-1	CEU
GATCTAGCAATCTGCA-1	YRI
GATCTAGCAGCGTTCG-1	CEU
GATCTAGGTAAACCTC-1	YRI
GATCTAGGTGGACGAT-1	CEU
GATCTAGGTTACTGAC-1	CEU
GATCTAGTCTGGTTCC-1	YRI
GATCTAGTCTGTCCGT-1	YRI
GATGAAAAGACAATAC-1	CEU
GATGAAAAGATGTAAC-1	YRI
GATGAAACAAGTCTAC-1	CEU
GATGAAACAATCCAAC-1	CEU
GATGAAACAGGATTGG-1	YRI
GATGAAACAGTGGAGT-1	YRI
GATGAAAGTAAGAGGA-1	CEU
GATGAAAGTAGCGCTC-1	CEU
GATGAAAGTAGTAGTA-1	CEU
GATGAAAGTCACCCAG-1	CEU
GATGAAAGTGGTGTAG-1	CEU
GATGAAATCTACCAGA-1	CEU
GATGAAATCTGACCTC-1	CEU
GATGAGGCAAGAGGCT-1	YRI
GATGAGGCAAGGACAC-1	YRI
GATGAGGCAAGTCTAC-1	YRI
GATGAGGCAATGTTGC-1	YRI
GATGAGGCACATGTGT-1	YRI
GATGAGGCACCAGTTA-1	CEU
GATGAGGCACCTCGTT-1	YRI
GATGAGGCAGTAGAGC-1	YRI
GATGAGGCATCGTCGG-1	YRI
GATGAGGGTATGAAAC-1	CEU
GATGAGGGTCGCGTGT-1	YRI
GATGAGGTCGTACGGC-1	YRI
GATGCTACATGAGCGA-1	CEU
GATGCTAGTAAATGTG-1	YRI
GATGCTATCCCAACGG-1	CEU
GATGCTATCCGAAGAG-1	YRI
GATGCTATCTGTTGAG-1	YRI
GATTCAGAGAGTACCG-1	YRI
GATTCAGCATCCCACT-1	CEU
GATTCAGGTACCGAGA-1	YRI
GATTCAGGTGAGCGAT-1	YRI
GATTCAGGTTCCATGA-1	YRI
GCAAACTAGAATTCCC-1	YRI
GCAAACTCATGGGACA-1	YRI
GCAAACTCATGTAGTC-1	CEU
GCAAACTGTGCACCAC-1	YRI
GCAAACTGTGCGATAG-1	CEU
GCAATCAAGCAGGCTA-1	YRI
GCAATCAAGCGATTCT-1	YRI
GCAATCAAGCTGGAAC-1	YRI
GCAATCAAGGCTATCT-1	YRI
GCAATCACAGGTCTCG-1	CEU
GCAATCAGTATGGTTC-1	CEU
GCAATCAGTCTCAACA-1	YRI
GCAATCAGTGAAATCA-1	YRI
GCAATCATCCACGTTC-1	YRI
GCAATCATCCAGAAGG-1	CEU
GCAATCATCTCGCATC-1	CEU
GCACATAAGAAGGGTA-1	CEU
GCACATAAGACAAGCC-1	YRI
GCACATAAGATGTTAG-1	YRI
GCACATAAGTACGCCC-1	CEU
GCACATACAAGAGGCT-1	CEU
GCACATACAAGCGATG-1	CEU
GCACATACAATCTACG-1	CEU
GCACATACAGGGTTAG-1	CEU
GCACATACATGGTAGG-1	YRI
GCACATAGTAAGGGCT-1	YRI
GCACATAGTTGCGTTA-1	YRI
GCACATAGTTGTGGCC-1	CEU
GCACATATCCTATTCA-1	YRI
GCACTCTAGATGTGTA-1	CEU
GCACTCTAGCCAACAG-1	YRI
GCACTCTAGTCGAGTG-1	CEU
GCACTCTCAAGCCGTC-1	CEU
GCACTCTCAGCCTTTC-1	CEU
GCACTCTCATTGAGCT-1	YRI
GCACTCTCATTTCAGG-1	YRI
GCACTCTGTTTGACTG-1	CEU
GCACTCTTCAGTGCAT-1	CEU
GCACTCTTCCACGTTC-1	YRI
GCACTCTTCCACTCCA-1	CEU
GCACTCTTCGGTCTAA-1	YRI
GCACTCTTCGGTGTCG-1	YRI
GCACTCTTCTGCGGCA-1	YRI
GCAGCCAAGTGCTGCC-1	CEU
GCAGCCACAAACGCGA-1	YRI
GCAGCCACAGTCACTA-1	YRI
GCAGCCAGTACCGGCT-1	YRI
GCAGCCAGTAGTACCT-1	YRI
GCAGCCAGTCAATGTC-1	YRI
GCAGCCAGTCTCATCC-1	YRI
GCAGCCAGTGTAACGG-1	YRI
GCAGCCATCTACTCAT-1	YRI
GCAGCCATCTGCGACG-1	YRI
GCAGCCATCTTACCTA-1	CEU
GCAGTTAAGAAACGAG-1	CEU
GCAGTTAAGAGTACAT-1	YRI
GCAGTTACACAACGCC-1	YRI
GCAGTTACACGTGAGA-1	CEU
GCAGTTAGTATTAGCC-1	CEU
GCAGTTAGTCGGATCC-1	YRI
GCAGTTATCAACGGGA-1	YRI
GCAGTTATCGAATGCT-1	YRI
GCATACAAGCTCCTCT-1	YRI
GCATACACACCAGTTA-1	YRI
GCATACACATGGTCTA-1	YRI
GCATACAGTATGAAAC-1	CEU
GCATACAGTCTAAACC-1	CEU
GCATACAGTCTCCCTA-1	CEU
GCATACAGTCTGATTG-1	CEU
GCATACAGTGGCTCCA-1	YRI
GCATACATCAAGAAGT-1	YRI
GCATACATCATGCAAC-1	CEU
GCATACATCGGAATCT-1	CEU
GCATACATCGTAGGTT-1	CEU
GCATGATAGCTAAACA-1	YRI
GCATGATAGGACAGCT-1	YRI
GCATGATAGGAGTACC-1	YRI
GCATGATAGTATTGGA-1	CEU
GCATGATCAAAGCAAT-1	CEU
GCATGATCAACGCACC-1	YRI
GCATGATGTATGAATG-1	CEU
GCATGATGTCACTGGC-1	CEU
GCATGATGTCTACCTC-1	CEU
GCATGATGTTTAGCTG-1	CEU
GCATGATTCTGGTATG-1	YRI
GCATGCGAGGAGCGTT-1	YRI
GCATGCGAGGTCATCT-1	CEU
GCATGCGCAATCCAAC-1	YRI
GCATGCGCACAGAGGT-1	YRI
GCATGCGCAGGTCCAC-1	YRI
GCATGCGCATACTACG-1	YRI
GCATGCGGTCTCTTAT-1	CEU
GCATGCGGTGTGACGA-1	CEU
GCATGCGGTTAAGAAC-1	YRI
GCATGCGTCGCAAACT-1	CEU
GCATGCGTCGCAGGCT-1	CEU
GCATGTAAGAACAACT-1	YRI
GCATGTAAGAGTACAT-1	YRI
GCATGTAAGATGCCTT-1	CEU
GCATGTAAGTTATCGC-1	YRI
GCATGTACAAACTGCT-1	CEU
GCATGTACAGAGTGTG-1	CEU
GCATGTACAGGCTGAA-1	YRI
GCATGTAGTAAACACA-1	YRI
GCATGTAGTCAGGACA-1	YRI
GCATGTATCTAGCACA-1	YRI
GCATGTATCTCTAGGA-1	YRI
GCATGTATCTGCTGCT-1	YRI
GCCAAATAGCCACGCT-1	YRI
GCCAAATAGCCATCGC-1	YRI
GCCAAATAGTCGATAA-1	YRI
GCCAAATAGTGGGATC-1	YRI
GCCAAATAGTTTGCGT-1	YRI
GCCAAATCAGACACTT-1	CEU
GCCAAATGTACACCGC-1	YRI
GCCAAATGTCCCGACA-1	YRI
GCCAAATGTCTCGTTC-1	YRI
GCCAAATGTGCTAGCC-1	CEU
GCCAAATTCGAATCCA-1	YRI
GCCAAATTCTTAACCT-1	YRI
GCCTCTAAGAATTGTG-1	YRI
GCCTCTAAGACAAGCC-1	CEU
GCCTCTAAGCCCAGCT-1	CEU
GCCTCTACATGTCTCC-1	CEU
GCCTCTAGTAAACCTC-1	YRI
GCCTCTAGTAGGGTAC-1	CEU
GCCTCTAGTTGCGCAC-1	YRI
GCCTCTATCCAGATCA-1	CEU
GCCTCTATCCTCATTA-1	YRI
GCCTCTATCGCAAACT-1	YRI
GCCTCTATCGGAGCAA-1	CEU
GCCTCTATCGGCGGTT-1	CEU
GCGACCAAGAATTCCC-1	CEU
GCGACCAAGCCCAGCT-1	CEU
GCGACCACACCAGATT-1	CEU
GCGACCACACGAGAGT-1	CEU
GCGACCACATCATCCC-1	CEU
GCGACCACATCTATGG-1	YRI
GCGACCAGTCAACATC-1	YRI
GCGACCAGTGGCTCCA-1	YRI
GCGACCATCAGCAACT-1	YRI
GCGACCATCTGACCTC-1	YRI
GCGAGAAAGAGCAATT-1	CEU
GCGAGAAAGTGTGAAT-1	YRI
GCGAGAACAAGAAAGG-1	YRI
GCGAGAACAAGCCTAT-1	YRI
GCGAGAACACGGTTTA-1	CEU
GCGAGAACATGGGAAC-1	CEU
GCGAGAAGTAGCTTGT-1	YRI
GCGAGAAGTCAATACC-1	YRI
GCGAGAAGTTGAACTC-1	YRI
GCGAGAATCAGTGTTG-1	CEU
GCGAGAATCCCTCTTT-1	CEU
GCGAGAATCGGCCGAT-1	YRI
GCGAGAATCTTGCATT-1	CEU
GCGCAACAGAAGGTGA-1	CEU
GCGCAACAGCCAGTTT-1	YRI
GCGCAACAGTCCGGTC-1	CEU
GCGCAACCAAGACGTG-1	YRI
GCGCAACCACATTAGC-1	YRI
GCGCAACCACCGGAAA-1	YRI
GCGCAACCACGACTCG-1	YRI
GCGCAACCAGACTCGC-1	CEU
GCGCAACGTCAGAAGC-1	YRI
GCGCAACGTGCCTGGT-1	YRI
GCGCAACGTGCTGTAT-1	YRI
GCGCAACGTGTCAATC-1	YRI
GCGCAACGTTACGCGC-1	YRI
GCGCAACTCCCAAGAT-1	CEU
GCGCAACTCGTTGCCT-1	YRI
GCGCAACTCTTTAGGG-1	YRI
GCGCAGTAGATCTGCT-1	YRI
GCGCAGTAGGCCCTCA-1	CEU
GCGCAGTCAAAGCAAT-1	CEU
GCGCAGTCAAGTCTGT-1	YRI
GCGCAGTCATGTCTCC-1	YRI
GCGCAGTCATTTGCTT-1	CEU
GCGCAGTGTCACAAGG-1	YRI
GCGCAGTGTCCGACGT-1	CEU
GCGCAGTGTGTTAAGA-1	YRI
GCGCAGTGTTAGAACA-1	YRI
GCGCAGTGTTGATTGC-1	YRI
GCGCAGTTCAGTGTTG-1	YRI
GCGCAGTTCATGGTCA-1	YRI
GCGCAGTTCGTCTGAA-1	CEU
GCGCCAAGTACTCTCC-1	YRI
GCGCCAAGTCCGACGT-1	YRI
GCGCCAAGTGAGGGTT-1	CEU
GCGCCAAGTGGGTCAA-1	CEU
GCGCCAAGTTCCCGAG-1	YRI
GCGCCAAGTTCCGTCT-1	YRI
GCGCCAATCACCCTCA-1	YRI
GCGCCAATCCCATTAT-1	CEU
GCGCCAATCTCCAGGG-1	YRI
GCGCCAATCTGTTTGT-1	CEU
GCGCGATAGGGCTTCC-1	CEU
GCGCGATAGTGTTGAA-1	YRI
GCGCGATCACCACCAG-1	CEU
GCGCGATCAGCTGTTA-1	YRI
GCGCGATCAGGGTTAG-1	CEU
GCGCGATCAGTATCTG-1	YRI
GCGCGATCATTAGCCA-1	YRI
GCGCGATGTCCTCTTG-1	YRI
GCGCGATGTCGCATCG-1	YRI
GCGCGATGTCTAGTCA-1	YRI
GCGCGATGTCTGGTCG-1	CEU
GCGCGATTCATCTGTT-1	CEU
GCGCGATTCGTAGATC-1	CEU
GCGGGTTAGAGCCCAA-1	CEU
GCGGGTTAGAGTAAGG-1	YRI
GCGGGTTAGCAGGTCA-1	YRI
GCGGGTTCAATCACAC-1	YRI
GCGGGTTCACTTGGAT-1	YRI
GCGGGTTCAGCAGTTT-1	YRI
GCGGGTTCAGGCGATA-1	YRI
GCGGGTTCAGTCAGAG-1	CEU
GCGGGTTCAGTCGATT-1	CEU
GCGGGTTCATTCTTAC-1	YRI
GCGGGTTGTACATCCA-1	YRI
GCGGGTTTCAGTACGT-1	CEU
GCGGGTTTCCACTGGG-1	CEU
GCGGGTTTCGACAGCC-1	YRI
GCGGGTTTCGTCCGTT-1	YRI
GCTCCTAAGCACACAG-1	YRI
GCTCCTACAAACGTGG-1	YRI
GCTCCTACAGCCAATT-1	YRI
GCTCCTAGTAGCTAAA-1	CEU
GCTCCTAGTCTTCTCG-1	CEU
GCTCCTATCACCTCGT-1	YRI
GCTCCTATCGGAAATA-1	CEU
GCTCCTATCTATCCTA-1	YRI
GCTCTGTCACGGCCAT-1	CEU
GCTCTGTCAGCTATTG-1	CEU
GCTCTGTGTATAATGG-1	CEU
GCTCTGTTCATGTAGC-1	YRI
GCTCTGTTCCGGGTGT-1	CEU
GCTCTGTTCGTTACGA-1	YRI
GCTCTGTTCTGCGTAA-1	YRI
GCTCTGTTCTGGTGTA-1	YRI
GCTGCAGAGAAGCCCA-1	YRI
GCTGCAGAGATGGGTC-1	YRI
GCTGCAGAGGACAGAA-1	CEU
GCTGCAGAGGCCCTCA-1	CEU
GCTGCAGAGTTAAGTG-1	YRI
GCTGCAGCAATGGACG-1	YRI
GCTGCAGCAGAGCCAA-1	YRI
GCTGCAGGTCCAAGTT-1	CEU
GCTGCAGGTGGTGTAG-1	YRI
GCTGCAGTCAACGAAA-1	CEU
GCTGCAGTCCTTGGTC-1	CEU
GCTGCAGTCTGATACG-1	YRI
GCTGCAGTCTGTTGAG-1	YRI
GCTGCGAAGAAACGAG-1	CEU
GCTGCGAAGAAGGTTT-1	YRI
GCTGCGAAGATACACA-1	YRI
GCTGCGAAGCGTCTAT-1	CEU
GCTGCGAAGGATGCGT-1	YRI
GCTGCGAAGTCGTTTG-1	YRI
GCTGCGACAGACAGGT-1	CEU
GCTGCGACAGTGACAG-1	CEU
GCTGCGAGTAAAGGAG-1	YRI
GCTGCGAGTACCTACA-1	YRI
GCTGCGAGTATATCCG-1	CEU
GCTGCGAGTTGAACTC-1	YRI
GCTGCGAGTTGATTGC-1	YRI
GCTGCGAGTTGTCTTT-1	CEU
GCTGCGATCATTTGGG-1	YRI
GCTGCGATCCCTAACC-1	YRI
GCTGCGATCTTACCTA-1	YRI
GCTGCTTAGCCAGTTT-1	CEU
GCTGCTTAGTCCCACG-1	YRI
GCTGCTTCACACGCTG-1	CEU
GCTGCTTCAGCAGTTT-1	YRI
GCTGCTTGTAGTACCT-1	CEU
GCTGCTTGTCTGATTG-1	CEU
GCTGCTTGTGTTGAGG-1	CEU
GCTGCTTGTTGAGGTG-1	YRI
GCTGCTTTCAGCCTAA-1	CEU
GCTGCTTTCTCTGCTG-1	CEU
GCTGGGTAGCCCAACC-1	YRI
GCTGGGTCATAACCTG-1	YRI
GCTGGGTCATGGGACA-1	CEU
GCTGGGTGTCCAGTTA-1	YRI
GCTGGGTGTGAAAGAG-1	CEU
GCTGGGTGTGTTGAGG-1	CEU
GCTGGGTGTTGTGGCC-1	CEU
GCTGGGTTCAACACTG-1	CEU
GCTGGGTTCACGAAGG-1	CEU
GCTGGGTTCAGCGACC-1	CEU
GCTGGGTTCTTCATGT-1	YRI
GCTTCCAAGAGCTGGT-1	YRI
GCTTCCAAGATAGGAG-1	YRI
GCTTCCAAGTCAAGGC-1	YRI
GCTTCCAAGTTAGCGG-1	CEU
GCTTCCACACACATGT-1	CEU
GCTTCCACAGCTTAAC-1	CEU
GCTTCCACATTAGCCA-1	YRI
GCTTCCAGTAGCTTGT-1	YRI
GCTTCCAGTCTAGAGG-1	YRI
GCTTCCATCAACACGT-1	YRI
GCTTCCATCCCGACTT-1	CEU
GCTTCCATCCGTAGTA-1	CEU
GCTTCCATCTAACTGG-1	CEU
GCTTCCATCTGACCTC-1	YRI
GCTTGAAAGAGTCGGT-1	CEU
GCTTGAACACACGCTG-1	YRI
GCTTGAACACCCTATC-1	CEU
GCTTGAACACTAGTAC-1	CEU
GCTTGAACAGATGGGT-1	YRI
GCTTGAACAGTCCTTC-1	YRI
GCTTGAAGTGTAATGA-1	YRI
GCTTGAAGTGTTTGTG-1	CEU
GCTTGAAGTTGATTGC-1	CEU
GCTTGAATCTAACCGA-1	YRI
GGAAAGCAGGTCGGAT-1	YRI
GGAAAGCAGTCCCACG-1	YRI
GGAAAGCCAAACCTAC-1	YRI
GGAAAGCCAAGGACAC-1	CEU
GGAAAGCCACCCATGG-1	CEU
GGAAAGCCAGGTTTCA-1	YRI
GGAAAGCCATTCTCAT-1	CEU
GGAAAGCGTAGCTGCC-1	CEU
GGAAAGCTCCAAGCCG-1	YRI
GGAACTTAGCCGTCGT-1	YRI
GGAACTTAGCGGCTTC-1	CEU
GGAACTTAGTACGTTC-1	CEU
GGAACTTAGTCCCACG-1	YRI
GGAACTTCAGATAATG-1	YRI
GGAACTTCATAGAAAC-1	YRI
GGAACTTCATATACCG-1	YRI
GGAACTTCATGCTAGT-1	YRI
GGAACTTCATTCGACA-1	CEU
GGAACTTGTAAGTGTA-1	CEU
GGAACTTGTAGAGCTG-1	YRI
GGAACTTGTCTCTCGT-1	CEU
GGAACTTGTGGCAAAC-1	YRI
GGAACTTGTTAAGATG-1	CEU
GGAACTTTCATCATTC-1	CEU
GGAACTTTCCAAAGTC-1	CEU
GGAATAAAGATCCCGC-1	YRI
GGAATAAAGCCGATTT-1	CEU
GGAATAAAGGGTGTGT-1	YRI
GGAATAAAGGTCGGAT-1	YRI
GGAATAACAATAGCAA-1	YRI
GGAATAACACCTGGTG-1	YRI
GGAATAACACTTAACG-1	YRI
GGAATAACATGAACCT-1	CEU
GGAATAACATGAAGTA-1	YRI
GGAATAACATTGGTAC-1	CEU
GGAATAAGTCTTGCGG-1	YRI
GGAATAAGTGAGTATA-1	YRI
GGAATAAGTGGTGTAG-1	YRI
GGAATAATCAACGGGA-1	CEU
GGAATAATCCTCAACC-1	CEU
GGAATAATCCTGCAGG-1	YRI
GGAATAATCGGAAACG-1	YRI
GGAATAATCTGCCAGG-1	CEU
GGAATAATCTTCATGT-1	CEU
GGACAAGAGACTTGAA-1	CEU
GGACAAGAGAGCTGCA-1	CEU
GGACAAGAGCACAGGT-1	CEU
GGACAAGAGCGCCTTG-1	CEU
GGACAAGAGTCTCCTC-1	YRI
GGACAAGCACCGATAT-1	CEU
GGACAAGCATACTCTT-1	YRI
GGACAAGCATTCCTCG-1	CEU
GGACAAGTCATGCATG-1	YRI
GGACAGAAGATGTCGG-1	YRI
GGACAGACAACGATCT-1	CEU
GGACAGACACCGCTAG-1	CEU
GGACAGACATCCCACT-1	CEU
GGACAGACATCGACGC-1	YRI
GGACAGAGTAGGACAC-1	YRI
GGACAGAGTATGGTTC-1	CEU
GGACAGAGTGATAAGT-1	YRI
GGACAGAGTGGTACAG-1	YRI
GGACATTAGGCATGGT-1	CEU
GGACATTCAAAGGAAG-1	CEU
GGACATTCAAATTGCC-1	YRI
GGACATTCAATGGAGC-1	YRI
GGACATTCACGCCAGT-1	YRI
GGACATTCAGGATTGG-1	YRI
GGACATTCATCGTCGG-1	CEU
GGACATTGTCTCAACA-1	YRI
GGACATTGTGCTTCTC-1	YRI
GGACATTGTTAGATGA-1	CEU
GGACATTGTTCAGGCC-1	YRI
GGACATTTCCTGCAGG-1	YRI
GGACATTTCGGAGGTA-1	YRI
GGACGTCAGAGCTGCA-1	CEU
GGACGTCAGGACGAAA-1	YRI
GGACGTCAGGGTCTCC-1	YRI
GGACGTCAGGTGTTAA-1	YRI
GGACGTCAGTGATCGG-1	CEU
GGACGTCCAAGAGTCG-1	YRI
GGACGTCCAAGTAGTA-1	YRI
GGACGTCCACAGGAGT-1	CEU
GGACGTCCACTGTGTA-1	YRI
GGACGTCGTCACCTAA-1	YRI
GGACGTCGTCTAGCCG-1	CEU
GGACGTCGTCTGATCA-1	YRI
GGACGTCTCCTCAATT-1	YRI
GGACGTCTCTGCTGCT-1	YRI
GGACGTCTCTTGTCAT-1	YRI
GGAGCAAAGACTTTCG-1	YRI
GGAGCAAAGTTTCCTT-1	YRI
GGAGCAACACTGCCAG-1	CEU
GGAGCAACATCCCACT-1	YRI
GGAGCAACATCTGGTA-1	CEU
GGAGCAAGTATGAAAC-1	YRI
GGAGCAAGTGAGCGAT-1	YRI
GGAGCAAGTTCACCTC-1	CEU
GGAGCAAGTTCCACAA-1	YRI
GGAGCAAGTTTGTTGG-1	CEU
GGAGCAATCGCAAACT-1	CEU
GGATGTTAGACCCACC-1	CEU
GGATGTTAGTAGCGGT-1	CEU
GGATGTTAGTCGAGTG-1	CEU
GGATGTTAGTTAAGTG-1	YRI
GGATGTTCAATCAGAA-1	YRI
GGATGTTCACAGCGTC-1	CEU
GGATGTTCATTGGGCC-1	CEU
GGATGTTGTACATCCA-1	YRI
GGATGTTGTATCAGTC-1	YRI
GGATGTTGTCAACATC-1	YRI
GGATGTTGTCCATGAT-1	CEU
GGATGTTGTCTACCTC-1	YRI
GGATGTTGTCTGCAAT-1	CEU
GGATGTTGTGCGGTAA-1	YRI
GGATGTTGTGTGTGCC-1	CEU
GGATGTTGTGTTGAGG-1	YRI
GGATTACAGATCTGCT-1	CEU
GGATTACAGCACACAG-1	CEU
GGATTACAGTGTCCCG-1	CEU
GGATTACCATGAGCGA-1	CEU
GGATTACCATGGGACA-1	YRI
GGATTACGTAAAGTCA-1	YRI
GGATTACGTCAGTGGA-1	YRI
GGATTACGTGACTCAT-1	CEU
GGATTACGTGCCTGGT-1	CEU
GGATTACTCCGAGCCA-1	YRI
GGATTACTCTGCAAGT-1	CEU
GGATTACTCTGTCCGT-1	YRI
GGCAATTAGACACGAC-1	YRI
GGCAATTAGCCAGGAT-1	YRI
GGCAATTAGGCATGTG-1	YRI
GGCAATTAGGGCTTGA-1	CEU
GGCAATTAGTTGCAGG-1	CEU
GGCAATTCACCGAAAG-1	CEU
GGCAATTCACCGATAT-1	YRI
GGCAATTCAGCCTGTG-1	CEU
GGCAATTGTCCTGCTT-1	YRI
GGCAATTGTGATGATA-1	CEU
GGCAATTGTTTGTGTG-1	CEU
GGCCGATAGATCGGGT-1	YRI
GGCCGATAGTATTGGA-1	YRI
GGCCGATCACGAGAGT-1	YRI
GGCCGATCACTCTGTC-1	CEU
GGCCGATCATGTTGAC-1	YRI
GGCCGATGTAATAGCA-1	YRI
GGCCGATGTATATGGA-1	CEU
GGCCGATGTCGAACAG-1	CEU
GGCCGATGTTCGGGCT-1	YRI
GGCCGATTCAAACCGT-1	YRI
GGCGACTAGAAACGAG-1	YRI
GGCGACTAGATCCGAG-1	CEU
GGCGACTAGATGCGAC-1	YRI
GGCGACTAGCGTGAGT-1	CEU
GGCGACTAGGCAGGTT-1	YRI
GGCGACTAGGGATACC-1	YRI
GGCGACTAGGTGCACA-1	CEU
GGCGACTCATGACATC-1	YRI
GGCGACTGTAGCCTAT-1	YRI
GGCGACTGTGAGGGTT-1	YRI
GGCGACTGTGCATCTA-1	YRI
GGCGACTGTTCTGAAC-1	YRI
GGCGACTTCGTAGGAG-1	YRI
GGCGACTTCGTTGACA-1	CEU
GGCGACTTCTCTTATG-1	YRI
GGCGTGTAGCTAGCCC-1	YRI
GGCGTGTAGCTGAACG-1	YRI
GGCGTGTCAAGCCATT-1	CEU
GGCGTGTCACTGTCGG-1	CEU
GGCGTGTCAGCCACCA-1	YRI
GGCGTGTGTAAGTGGC-1	YRI
GGCGTGTGTAGCTGCC-1	YRI
GGCGTGTGTGACAAAT-1	YRI
GGCGTGTGTTGACGTT-1	CEU
GGCGTGTTCCAGTAGT-1	CEU
GGCGTGTTCGTGGTCG-1	CEU
GGCGTGTTCTCAACTT-1	CEU
GGCGTGTTCTCCAACC-1	YRI
GGCTCGAAGAAGGTTT-1	CEU
GGCTCGAAGACAGGCT-1	CEU
GGCTCGAAGAGGTTAT-1	YRI
GGCTCGAAGATGCGAC-1	YRI
GGCTCGAAGCAATCTC-1	CEU
GGCTCGAAGCAGATCG-1	YRI
GGCTCGAAGCCAGGAT-1	YRI
GGCTCGAAGGACAGCT-1	YRI
GGCTCGAAGGGTTTCT-1	CEU
GGCTCGAAGTAGGTGC-1	YRI
GGCTCGACAAAGCAAT-1	YRI
GGCTCGACAAGGTTCT-1	CEU
GGCTCGACAGTTCCCT-1	YRI
GGCTCGACATCGGTTA-1	YRI
GGCTCGACATGTCGAT-1	CEU
GGCTCGAGTAAGTAGT-1	YRI
GGCTCGAGTATAATGG-1	YRI
GGCTCGAGTGGCTCCA-1	CEU
GGCTCGATCACTTACT-1	CEU
GGCTCGATCAGATAAG-1	YRI
GGCTGGTAGGAACTGC-1	CEU
GGCTGGTCATGGTCTA-1	CEU
GGCTGGTCATTCCTCG-1	CEU
GGCTGGTGTAGGGTAC-1	CEU
GGCTGGTGTCCATGAT-1	YRI
GGCTGGTTCCACGTTC-1	CEU
GGCTGGTTCGCGATCG-1	YRI
GGCTGGTTCGTAGATC-1	YRI
GGGAATGAGTTGAGTA-1	CEU
GGGAATGCAACACCTA-1	YRI
GGGAATGCACGGCGTT-1	YRI
GGGAATGCAGCCAGAA-1	YRI
GGGAATGCATCCAACA-1	YRI
GGGAATGGTTCTCATT-1	YRI
GGGAATGTCCGATATG-1	YRI
GGGAATGTCTGGCGAC-1	CEU
GGGAATGTCTGGGCCA-1	CEU
GGGACCTAGAATTGTG-1	YRI
GGGACCTAGACGCAAC-1	YRI
GGGACCTAGAGACTAT-1	YRI
GGGACCTAGCCCAATT-1	CEU
GGGACCTAGCTCAACT-1	YRI
GGGACCTCAGCTTCGG-1	YRI
GGGACCTCAGGGAGAG-1	YRI
GGGACCTCAGGGTACA-1	CEU
GGGACCTGTAAGAGAG-1	CEU
GGGACCTGTCCGTCAG-1	YRI
GGGACCTGTCGCCATG-1	CEU
GGGACCTGTCTCTCTG-1	YRI
GGGACCTGTTGACGTT-1	CEU
GGGACCTTCTCCAACC-1	YRI
GGGACCTTCTCGTTTA-1	YRI
GGGACCTTCTTTACGT-1	YRI
GGGAGATAGTAGCGGT-1	CEU
GGGAGATAGTCGATAA-1	YRI
GGGAGATAGTGAATTG-1	CEU
GGGAGATAGTGGTAAT-1	YRI
GGGAGATCAGCTATTG-1	CEU
GGGAGATCAGCTGTAT-1	CEU
GGGAGATCAGGGCATA-1	CEU
GGGAGATCATGACATC-1	CEU
GGGAGATGTAGTAGTA-1	CEU
GGGAGATGTCTCTTTA-1	YRI
GGGAGATGTTGATTCG-1	YRI
GGGAGATGTTTGTGTG-1	YRI
GGGAGATTCAGCAACT-1	CEU
GGGAGATTCCACGCAG-1	YRI
GGGAGATTCGTACGGC-1	YRI
GGGATGAAGAGTTGGC-1	YRI
GGGATGAAGCGAGAAA-1	CEU
GGGATGAAGCGTGAGT-1	CEU
GGGATGACAAGGTTTC-1	YRI
GGGATGAGTACTTCTT-1	CEU
GGGATGAGTCCGCTGA-1	YRI
GGGATGATCGTGGTCG-1	YRI
GGGCACTAGCGATTCT-1	CEU
GGGCACTCAAGTTAAG-1	CEU
GGGCACTCACTATCTT-1	YRI
GGGCACTGTCGCTTCT-1	YRI
GGGCACTTCCGCAGTG-1	YRI
GGGCATCAGTGGAGAA-1	YRI
GGGCATCAGTTCGATC-1	YRI
GGGCATCGTAGAGCTG-1	YRI
GGGCATCGTAGTGAAT-1	CEU
GGGCATCGTCCAACTA-1	CEU
GGGCATCGTCTCTTAT-1	YRI
GGGCATCGTGCTTCTC-1	YRI
GGGCATCGTTCTCATT-1	YRI
GGGCATCGTTTAAGCC-1	YRI
GGGCATCTCTAAGCCA-1	YRI
GGGTCTGAGAATAGGG-1	YRI
GGGTCTGAGGCACATG-1	YRI
GGGTCTGAGGGTGTTG-1	YRI
GGGTCTGAGTAATCCC-1	YRI
GGGTCTGCAGCAGTTT-1	CEU
GGGTCTGCAGCCAGAA-1	YRI
GGGTCTGCATCATCCC-1	CEU
GGGTCTGCATGGGACA-1	YRI
GGGTCTGGTAGATTAG-1	YRI
GGGTCTGGTGTCCTCT-1	YRI
GGGTCTGGTGTGACGA-1	YRI
GGGTCTGTCACTTCAT-1	YRI
GGGTCTGTCTTAACCT-1	CEU
GGGTTGCAGGCGTACA-1	CEU
GGGTTGCCACGACGAA-1	CEU
GGGTTGCCAGTAACGG-1	YRI
GGGTTGCCATCGGACC-1	CEU
GGGTTGCCATGCAATC-1	YRI
GGGTTGCCATGTAGTC-1	YRI
GGGTTGCGTGCACCAC-1	YRI
GGGTTGCGTTGGTGGA-1	CEU
GGGTTGCGTTTACTCT-1	CEU
GGGTTGCTCATAAAGG-1	YRI
GGGTTGCTCCGCGGTA-1	CEU
GGGTTGCTCGGTGTTA-1	YRI
GGGTTGCTCGTCCGTT-1	CEU
GGTATTGAGGAGTTTA-1	YRI
GGTATTGAGGCTAGCA-1	CEU
GGTATTGAGGTAGCTG-1	CEU
GGTATTGAGTCGATAA-1	YRI
GGTATTGCACGCATCG-1	YRI
GGTATTGGTTGAACTC-1	YRI
GGTATTGTCGATGAGG-1	YRI
GGTATTGTCGGAGCAA-1	YRI
GGTATTGTCGGCTTGG-1	YRI
GGTGAAGAGAAACGCC-1	YRI
GGTGAAGAGTGCGATG-1	YRI
GGTGAAGCACCCTATC-1	YRI
GGTGAAGCACCGGAAA-1	YRI
GGTGAAGCATGCCTTC-1	CEU
GGTGAAGGTAGGGTAC-1	CEU
GGTGAAGGTCCGTGAC-1	YRI
GGTGAAGGTTCAGGCC-1	YRI
GGTGAAGTCAACACAC-1	CEU
GGTGAAGTCCGCAGTG-1	YRI
GGTGAAGTCTGCGACG-1	CEU
GGTGCGTAGGAATCGC-1	CEU
GGTGCGTCACATGACT-1	YRI
GGTGCGTCAGCGATCC-1	YRI
GGTGCGTGTCATGCAT-1	YRI
GGTGCGTGTCGAGATG-1	YRI
GGTGCGTGTTGGAGGT-1	CEU
GGTGCGTGTTTAAGCC-1	YRI
GGTGCGTTCACGCGGT-1	CEU
GGTGCGTTCAGCACAT-1	0
GGTGCGTTCATCGGAT-1	YRI
GGTGCGTTCATCTGCC-1	YRI
GGTGCGTTCTGTACGA-1	YRI
GGTGTTACAAGCCTAT-1	YRI
GGTGTTACACAACGTT-1	YRI
GGTGTTACACGTCAGC-1	YRI
GGTGTTAGTACAGTGG-1	CEU
GGTGTTAGTCCGTTAA-1	CEU
GGTGTTAGTCCTCTTG-1	YRI
GGTGTTATCCGAACGC-1	CEU
GGTGTTATCCGTAGGC-1	YRI
GTAACGTAGATGTGTA-1	CEU
GTAACGTAGCAAATCA-1	CEU
GTAACGTAGTAGCCGA-1	YRI
GTAACGTCACCGAATT-1	YRI
GTAACGTCATCAGTAC-1	YRI
GTAACGTGTACGCACC-1	YRI
GTAACGTGTCTACCTC-1	CEU
GTAACGTGTGCAGGTA-1	YRI
GTAACGTGTGCTAGCC-1	CEU
GTAACGTGTTCAGGCC-1	CEU
GTAACGTTCGAATGGG-1	YRI
GTAACTGAGACGCAAC-1	YRI
GTAACTGAGATGCGAC-1	CEU
GTAACTGAGCTTTGGT-1	YRI
GTAACTGCAATCTGCA-1	YRI
GTAACTGCACCATGTA-1	YRI
GTAACTGCACGAAAGC-1	YRI
GTAACTGGTAATCACC-1	CEU
GTAACTGGTCCAGTTA-1	YRI
GTAACTGGTCCGAACC-1	YRI
GTAACTGGTGCGAAAC-1	YRI
GTAACTGGTGGCAAAC-1	YRI
GTAACTGGTTGCTCCT-1	YRI
GTACGTAAGAAACGAG-1	YRI
GTACGTACAAACCTAC-1	YRI
GTACGTACACCGATAT-1	YRI
GTACGTAGTCAGATAA-1	YRI
GTACGTATCAGTGCAT-1	CEU
GTACGTATCCTCGCAT-1	YRI
GTACGTATCGGCTACG-1	CEU
GTACGTATCTGTACGA-1	YRI
GTACTCCAGAAGGGTA-1	CEU
GTACTCCAGTACATGA-1	CEU
GTACTCCCACACCGAC-1	YRI
GTACTCCCATGACATC-1	CEU
GTACTCCGTACAGTGG-1	YRI
GTACTCCGTAGAAGGA-1	YRI
GTACTCCGTGGTGTAG-1	YRI
GTACTCCGTGTTGGGA-1	YRI
GTACTCCTCAACCATG-1	YRI
GTACTCCTCAACGCTA-1	YRI
GTACTCCTCCTTGGTC-1	CEU
GTACTCCTCGAATGCT-1	YRI
GTACTCCTCGCAAACT-1	CEU
GTACTCCTCGTAGGTT-1	CEU
GTACTCCTCGTCTGAA-1	CEU
GTACTTTAGATAGCAT-1	CEU
GTACTTTCACCGAATT-1	CEU
GTACTTTCACCGGAAA-1	YRI
GTACTTTCAGCGTCCA-1	CEU
GTACTTTCAGCTGTAT-1	CEU
GTACTTTCAGGGCATA-1	YRI
GTACTTTGTGGCTCCA-1	YRI
GTACTTTGTTGTGGCC-1	CEU
GTACTTTTCCATTCTA-1	YRI
GTACTTTTCTGTCAAG-1	CEU
GTACTTTTCTTTACAC-1	CEU
GTAGGCCAGCTGCCCA-1	YRI
GTAGGCCCAAACGTGG-1	YRI
GTAGGCCCAGCCTTGG-1	YRI
GTAGGCCGTACTTAGC-1	CEU
GTAGGCCGTCAGCTAT-1	CEU
GTAGGCCGTGTAATGA-1	CEU
GTAGGCCGTTAAGGGC-1	CEU
GTAGGCCTCGCCTGAG-1	YRI
GTAGTCAAGCTAGTTC-1	YRI
GTAGTCAAGCTCCCAG-1	CEU
GTAGTCAAGTTTGCGT-1	CEU
GTAGTCAGTACAGTGG-1	YRI
GTAGTCAGTAGCCTAT-1	CEU
GTAGTCAGTCACACGC-1	YRI
GTAGTCAGTCGAGATG-1	YRI
GTAGTCAGTGCACTTA-1	CEU
GTAGTCAGTGCCTGGT-1	YRI
GTAGTCAGTGTTCTTT-1	CEU
GTAGTCAGTTGGTGGA-1	CEU
GTAGTCATCATGTCCC-1	CEU
GTAGTCATCCGCGCAA-1	CEU
GTAGTCATCGACCAGC-1	CEU
GTAGTCATCGGCATCG-1	CEU
GTATCTTAGAGAACAG-1	YRI
GTATCTTAGCGTTCCG-1	YRI
GTATCTTCAACGCACC-1	CEU
GTATCTTCACAACGCC-1	CEU
GTATCTTCACATTCGA-1	CEU
GTATCTTCACCAGCAC-1	YRI
GTATCTTCACGCATCG-1	YRI
GTATCTTCAGGTCCAC-1	YRI
GTATCTTGTAGGACAC-1	YRI
GTATCTTGTTGGAGGT-1	CEU
GTATCTTTCGTTACGA-1	YRI
GTATCTTTCTCAACTT-1	CEU
GTATTCTAGAGGTACC-1	CEU
GTATTCTAGGCGACAT-1	YRI
GTATTCTCAGTGAGTG-1	YRI
GTATTCTGTGCCTGTG-1	CEU
GTATTCTGTGGAAAGA-1	YRI
GTATTCTTCCTGTACC-1	YRI
GTCAAGTCACACTGCG-1	YRI
GTCAAGTCACAGCCCA-1	YRI
GTCAAGTGTAGCCTCG-1	CEU
GTCAAGTGTATAGGGC-1	CEU
GTCAAGTGTATCTGCA-1	YRI
GTCAAGTGTCTCCACT-1	CEU
GTCAAGTGTGTTTGTG-1	YRI
GTCAAGTTCAAGGTAA-1	CEU
GTCAAGTTCCACTGGG-1	CEU
GTCAAGTTCCCACTTG-1	YRI
GTCACAAAGGCATGGT-1	CEU
GTCACAAAGTGTTTGC-1	YRI
GTCACAACAACTGCTA-1	YRI
GTCACAACACAAGCCC-1	CEU
GTCACAACAGGCTGAA-1	CEU
GTCACAAGTATATCCG-1	CEU
GTCACAAGTGCGCTTG-1	CEU
GTCACAAGTTACGACT-1	YRI
GTCACAATCCCTCAGT-1	YRI
GTCACGGCAAGCGTAG-1	YRI
GTCACGGCAGCTGCAC-1	YRI
GTCACGGGTAGAGTGC-1	YRI
GTCACGGGTCAGTGGA-1	YRI
GTCACGGGTTGCGCAC-1	CEU
GTCACGGTCAGTCAGT-1	YRI
GTCACGGTCGTAGATC-1	YRI
GTCATTTAGATACACA-1	CEU
GTCATTTAGCAATCTC-1	CEU
GTCATTTCACTTAAGC-1	CEU
GTCATTTCAGCTGTGC-1	CEU
GTCATTTCAGTATAAG-1	CEU
GTCATTTCATGCCTAA-1	YRI
GTCATTTGTAGCGTAG-1	YRI
GTCATTTGTTCCACAA-1	YRI
GTCATTTTCACTATTC-1	YRI
GTCATTTTCGTCTGAA-1	CEU
GTCATTTTCTCGGACG-1	CEU
GTCCTCAAGCAGGTCA-1	YRI
GTCCTCACACACGCTG-1	CEU
GTCCTCACACATCTTT-1	CEU
GTCCTCACACCGCTAG-1	YRI
GTCCTCACACCGTTGG-1	CEU
GTCCTCACATAACCTG-1	YRI
GTCCTCACATTGGTAC-1	YRI
GTCCTCAGTAAGTAGT-1	CEU
GTCCTCAGTGAGGCTA-1	YRI
GTCCTCAGTGCAGTAG-1	YRI
GTCCTCATCAAACAAG-1	YRI
GTCCTCATCCAATGGT-1	YRI
GTCGGGTAGATTACCC-1	CEU
GTCGGGTAGTACGACG-1	YRI
GTCGGGTCAAAGTCAA-1	CEU
GTCGGGTCACGACGAA-1	YRI
GTCGGGTCACTGCCAG-1	YRI
GTCGGGTGTGCAGGTA-1	YRI
GTCGGGTGTTCTGTTT-1	CEU
GTCGGGTTCCTTGACC-1	CEU
GTCGGGTTCTCGCATC-1	YRI
GTCGGGTTCTTCTGGC-1	YRI
GTCGTAAAGACTAGGC-1	CEU
GTCGTAAAGCTGGAAC-1	CEU
GTCGTAAAGGGAGTAA-1	YRI
GTCGTAAAGGGTTTCT-1	YRI
GTCGTAACAAGTACCT-1	YRI
GTCGTAACAGTTTACG-1	YRI
GTCGTAACATCACGAT-1	YRI
GTCGTAACATGACATC-1	YRI
GTCGTAAGTATAGGTA-1	YRI
GTCGTAATCAGTTTGG-1	CEU
GTCGTAATCTACTTAC-1	CEU
GTCTCGTAGCTTCGCG-1	CEU
GTCTCGTAGGGTGTGT-1	YRI
GTCTCGTCAATCCGAT-1	YRI
GTCTCGTCACCAGCAC-1	YRI
GTCTCGTCATCGATGT-1	YRI
GTCTCGTCATCGGAAG-1	CEU
GTCTCGTGTGCAACTT-1	YRI
GTCTCGTGTTACTGAC-1	CEU
GTCTCGTGTTCCTCCA-1	YRI
GTCTCGTTCAAGATCC-1	CEU
GTCTCGTTCAGAAATG-1	CEU
GTCTCGTTCCCAACGG-1	YRI
GTCTCGTTCGTTTAGG-1	CEU
GTCTCGTTCTATCGCC-1	CEU
GTCTTCGAGCCTTGAT-1	CEU
GTCTTCGAGGGCTCTC-1	CEU
GTCTTCGGTACCGTAT-1	YRI
GTCTTCGGTCCTCTTG-1	YRI
GTCTTCGGTTTGTTTC-1	CEU
GTCTTCGTCGTCCGTT-1	YRI
GTCTTCGTCTGTTGAG-1	CEU
GTGAAGGAGAACTGTA-1	YRI
GTGAAGGAGAAGGCCT-1	YRI
GTGAAGGAGAATTCCC-1	YRI
GTGAAGGAGACTACAA-1	YRI
GTGAAGGAGCCGATTT-1	YRI
GTGAAGGAGGATGGTC-1	YRI
GTGAAGGAGTTGAGAT-1	CEU
GTGAAGGCAACTGCGC-1	CEU
GTGAAGGCACAGATTC-1	CEU
GTGAAGGCACCGATAT-1	YRI
GTGAAGGCAGGTTTCA-1	YRI
GTGAAGGCAGTAACGG-1	CEU
GTGAAGGCATCGGACC-1	CEU
GTGAAGGGTCAGCTAT-1	YRI
GTGAAGGGTCGCGGTT-1	YRI
GTGAAGGGTTCGGCAC-1	YRI
GTGAAGGTCCTTTCTC-1	CEU
GTGAAGGTCGCGGATC-1	YRI
GTGCAGCAGAGGGCTT-1	YRI
GTGCAGCAGATCTGCT-1	YRI
GTGCAGCAGATGTAAC-1	CEU
GTGCAGCAGATGTCGG-1	CEU
GTGCAGCAGGACTGGT-1	YRI
GTGCAGCAGGTAGCCA-1	YRI
GTGCAGCCAAATACAG-1	CEU
GTGCAGCCACAAGTAA-1	YRI
GTGCAGCGTATATGGA-1	YRI
GTGCAGCGTCTAACGT-1	YRI
GTGCAGCGTGATAAAC-1	CEU
GTGCAGCTCAAAGTAG-1	YRI
GTGCAGCTCAACGGGA-1	CEU
GTGCAGCTCCAGATCA-1	CEU
GTGCAGCTCCATGAGT-1	CEU
GTGCAGCTCTCAACTT-1	YRI
GTGCATAAGACCTAGG-1	CEU
GTGCATAAGCCGCCTA-1	YRI
GTGCATAAGCGGATCA-1	YRI
GTGCATAAGTGCTGCC-1	YRI
GTGCATAAGTTGTAGA-1	YRI
GTGCATACAAATCCGT-1	CEU
GTGCATACAGAGCCAA-1	YRI
GTGCATACATACCATG-1	YRI
GTGCATAGTACAGTTC-1	YRI
GTGCATAGTACTTGAC-1	YRI
GTGCATAGTAGGACAC-1	YRI
GTGCATAGTCAATACC-1	CEU
GTGCATAGTCCGAACC-1	YRI
GTGCATATCAACGGCC-1	YRI
GTGCATATCAGTTTGG-1	CEU
GTGCATATCATCTGCC-1	YRI
GTGCATATCATGCAAC-1	YRI
GTGCATATCCTCATTA-1	CEU
GTGCGGTAGATGCCTT-1	YRI
GTGCGGTAGCAGCCTC-1	CEU
GTGCGGTAGCCGATTT-1	YRI
GTGCGGTCAATCCGAT-1	YRI
GTGCGGTCACCACCAG-1	YRI
GTGCGGTCACGGCCAT-1	CEU
GTGCGGTCAGTATAAG-1	YRI
GTGCGGTGTAGCAAAT-1	CEU
GTGCGGTGTGGTCCGT-1	YRI
GTGCGGTTCACTGGGC-1	YRI
GTGCGGTTCATCGGAT-1	CEU
GTGCGGTTCCTAGAAC-1	CEU
GTGCGGTTCTGACCTC-1	CEU
GTGCTTCAGAGTAATC-1	CEU
GTGCTTCAGGAATGGA-1	CEU
GTGCTTCAGGAGTCTG-1	YRI
GTGCTTCAGGTGCAAC-1	CEU
GTGCTTCAGTCTCCTC-1	CEU
GTGCTTCAGTTCGCAT-1	YRI
GTGCTTCCAAGACACG-1	YRI
GTGCTTCGTAAGCACG-1	YRI
GTGCTTCGTAGCTTGT-1	CEU
GTGCTTCGTCAGGACA-1	CEU
GTGCTTCGTTACTGAC-1	CEU
GTGCTTCTCAGGATCT-1	CEU
GTGCTTCTCCGTTGCT-1	CEU
GTGGGTCAGAGGGATA-1	CEU
GTGGGTCAGAGGTACC-1	CEU
GTGGGTCAGTACGCGA-1	YRI
GTGGGTCTCCGTAGGC-1	YRI
GTGGGTCTCTCTGTCG-1	YRI
GTGTGCGAGAAACGCC-1	CEU
GTGTGCGAGACACTAA-1	YRI
GTGTGCGAGCGTGTCC-1	CEU
GTGTGCGAGCTTTGGT-1	YRI
GTGTGCGCACCGGAAA-1	CEU
GTGTGCGCAGCCTGTG-1	CEU
GTGTGCGCATCCTAGA-1	CEU
GTGTGCGGTGCATCTA-1	YRI
GTGTGCGGTTAGATGA-1	YRI
GTGTGCGGTTCGCGAC-1	YRI
GTGTGCGTCATACGGT-1	YRI
GTGTGCGTCCTACAGA-1	YRI
GTGTGCGTCGACAGCC-1	YRI
GTGTGCGTCTTAACCT-1	YRI
GTGTTAGAGACTACAA-1	CEU
GTGTTAGAGCTGCAAG-1	CEU
GTGTTAGAGGGCTTCC-1	YRI
GTGTTAGAGTAACCCT-1	YRI
GTGTTAGAGTGGGCTA-1	YRI
GTGTTAGCAAAGGAAG-1	YRI
GTGTTAGCAGCCTATA-1	YRI
GTGTTAGGTAAATGAC-1	YRI
GTGTTAGGTACGCACC-1	YRI
GTGTTAGGTATAAACG-1	YRI
GTGTTAGGTCGAAAGC-1	CEU
GTGTTAGGTCGAACAG-1	CEU
GTGTTAGGTTCGTCTC-1	YRI
GTGTTAGGTTGTGGAG-1	YRI
GTGTTAGTCATGCAAC-1	YRI
GTTAAGCAGGACAGCT-1	CEU
GTTAAGCAGGCATGTG-1	CEU
GTTAAGCAGGCTCAGA-1	YRI
GTTAAGCAGTAGCGGT-1	CEU
GTTAAGCCAACTGCTA-1	YRI
GTTAAGCCAAGAGTCG-1	YRI
GTTAAGCCAGATCCAT-1	YRI
GTTAAGCCATACGCCG-1	YRI
GTTAAGCCATAGAAAC-1	CEU
GTTAAGCCATTCTTAC-1	CEU
GTTAAGCTCATACGGT-1	CEU
GTTAAGCTCCTGCAGG-1	YRI
GTTAAGCTCTCTGCTG-1	CEU
GTTAAGCTCTGGTATG-1	YRI
GTTAAGCTCTTGCAAG-1	YRI
GTTACAGAGACCCACC-1	YRI
GTTACAGAGCACCGTC-1	YRI
GTTACAGAGCCAGTTT-1	CEU
GTTACAGAGTATCGAA-1	CEU
GTTACAGCAGGTCCAC-1	YRI
GTTACAGGTAAACACA-1	YRI
GTTACAGTCAGCACAT-1	YRI
GTTACAGTCTGCGTAA-1	YRI
GTTCATTAGAAACGCC-1	CEU
GTTCATTAGAAGGTTT-1	YRI
GTTCATTAGAGACGAA-1	YRI
GTTCATTAGAGTACAT-1	CEU
GTTCATTAGCGCCTTG-1	YRI
GTTCATTAGCTACCGC-1	CEU
GTTCATTAGCTAGGCA-1	CEU
GTTCATTAGGCAATTA-1	CEU
GTTCATTCAAGCCTAT-1	YRI
GTTCATTCATACAGCT-1	CEU
GTTCATTGTACCGAGA-1	YRI
GTTCATTGTCAACATC-1	YRI
GTTCATTGTGATGCCC-1	YRI
GTTCATTTCAAGGTAA-1	CEU
GTTCATTTCCTCCTAG-1	YRI
GTTCATTTCGAGCCCA-1	CEU
GTTCATTTCTCGTATT-1	CEU
GTTCGGGAGGCAATTA-1	CEU
GTTCGGGCACAGAGGT-1	YRI
GTTCGGGGTAAGTTCC-1	YRI
GTTCGGGGTATATGGA-1	YRI
GTTCGGGTCGCCTGAG-1	CEU
GTTCGGGTCTGTCTCG-1	CEU
GTTCTCGAGCCAACAG-1	CEU
GTTCTCGAGGATATAC-1	CEU
GTTCTCGAGGATTCGG-1	YRI
GTTCTCGAGGTACTCT-1	CEU
GTTCTCGCAAAGGAAG-1	CEU
GTTCTCGCACATGTGT-1	YRI
GTTCTCGGTCAAACTC-1	CEU
GTTCTCGGTCTTGTCC-1	YRI
GTTCTCGGTGAACCTT-1	CEU
GTTCTCGGTGTAATGA-1	CEU
GTTCTCGGTTCAGCGC-1	CEU
GTTCTCGGTTGCTCCT-1	YRI
GTTCTCGTCCTCGCAT-1	YRI
GTTCTCGTCCTTAATC-1	YRI
GTTCTCGTCGACGGAA-1	YRI
GTTCTCGTCTTGAGAC-1	YRI
GTTTCTAAGTACGCCC-1	YRI
GTTTCTACACAAGCCC-1	CEU
GTTTCTACATCCTAGA-1	CEU
GTTTCTACATCTATGG-1	CEU
GTTTCTAGTTCCTCCA-1	YRI
GTTTCTAGTTGTACAC-1	YRI
GTTTCTATCACTTATC-1	YRI
GTTTCTATCCTATTCA-1	CEU
GTTTCTATCGAATGCT-1	CEU
GTTTCTATCGCCAAAT-1	YRI
TAAACCGAGAGCTATA-1	YRI
TAAACCGAGCCTCGTG-1	YRI
TAAACCGAGCGTTTAC-1	CEU
TAAACCGAGGCAGTCA-1	CEU
TAAACCGAGTCGCCGT-1	CEU
TAAACCGAGTGTACTC-1	YRI
TAAACCGCAGCTGTGC-1	CEU
TAAACCGGTTCAGGCC-1	YRI
TAAACCGTCAGTCAGT-1	YRI
TAAACCGTCCTGTACC-1	YRI
TAAACCGTCGACAGCC-1	CEU
TAAACCGTCTAGAGTC-1	CEU
TAAGAGAAGAGCTGCA-1	YRI
TAAGAGAAGAGGGCTT-1	YRI
TAAGAGAAGCACAGGT-1	YRI
TAAGAGAAGTCGAGTG-1	YRI
TAAGAGACAATCCGAT-1	CEU
TAAGAGACAGTTCATG-1	CEU
TAAGAGAGTGTTGAGG-1	YRI
TAAGCGTAGAGCCTAG-1	CEU
TAAGCGTAGCCTATGT-1	YRI
TAAGCGTAGGCAGTCA-1	CEU
TAAGCGTAGTAAGTAC-1	YRI
TAAGCGTCAAGGTGTG-1	YRI
TAAGCGTCACCCATTC-1	YRI
TAAGCGTCACGCGAAA-1	CEU
TAAGCGTCACTGCCAG-1	CEU
TAAGCGTCATCACAAC-1	YRI
TAAGCGTCATCGTCGG-1	YRI
TAAGCGTGTGTTGAGG-1	YRI
TAAGCGTTCCGATATG-1	CEU
TAAGCGTTCGACGGAA-1	YRI
TAAGCGTTCGTTTATC-1	CEU
TAAGTGCAGATATACG-1	YRI
TAAGTGCAGATGGGTC-1	YRI
TAAGTGCCAGTTTACG-1	YRI
TAAGTGCGTAGCGTAG-1	YRI
TAAGTGCGTATAGGGC-1	YRI
TAAGTGCGTCCAGTTA-1	YRI
TAAGTGCGTTCAGGCC-1	YRI
TAAGTGCGTTGGTAAA-1	YRI
TAAGTGCTCGAGGTAG-1	CEU
TAAGTGCTCGGAAATA-1	CEU
TAAGTGCTCGTTTAGG-1	CEU
TACACGAAGGGTGTGT-1	CEU
TACACGAAGGTCGGAT-1	CEU
TACACGAAGTACTTGC-1	YRI
TACACGAAGTGACTCT-1	CEU
TACACGACACTGTGTA-1	YRI
TACACGACATCGGACC-1	YRI
TACACGAGTAGGGACT-1	YRI
TACACGAGTCGGCTCA-1	CEU
TACACGAGTCTAGGTT-1	YRI
TACACGAGTCTCTTTA-1	YRI
TACACGAGTTACGGAG-1	CEU
TACACGATCAACACTG-1	YRI
TACACGATCATGGTCA-1	YRI
TACACGATCGTCGTTC-1	CEU
TACACGATCTGCAAGT-1	CEU
TACAGTGAGAGGGATA-1	YRI
TACAGTGCAAGCGCTC-1	CEU
TACAGTGCAAGTCTAC-1	YRI
TACAGTGCATTCCTGC-1	YRI
TACAGTGCATTTGCCC-1	CEU
TACAGTGGTCCGAGTC-1	YRI
TACAGTGGTGAAGGCT-1	CEU
TACAGTGGTGGAAAGA-1	CEU
TACAGTGTCGCCATAA-1	CEU
TACCTATAGCCACTAT-1	YRI
TACCTATAGTCAATAG-1	CEU
TACCTATCACGTCAGC-1	YRI
TACCTATCACTACAGT-1	YRI
TACCTATCAGTAACGG-1	YRI
TACCTATGTCCAAGTT-1	YRI
TACCTATGTCTTCGTC-1	YRI
TACCTATGTGCAGTAG-1	CEU
TACCTATGTTCGCTAA-1	CEU
TACCTATTCCGTACAA-1	YRI
TACCTATTCTTGTTTG-1	YRI
TACCTTAAGACCACGA-1	CEU
TACCTTAAGAGTAATC-1	CEU
TACCTTAAGGACAGAA-1	YRI
TACCTTAAGTCTTGCA-1	CEU
TACCTTAAGTTCGCGC-1	YRI
TACCTTACACGACTCG-1	CEU
TACCTTACATATGGTC-1	YRI
TACCTTACATTGGTAC-1	YRI
TACCTTAGTCCATGAT-1	YRI
TACCTTATCCGCAAGC-1	YRI
TACCTTATCCTTCAAT-1	YRI
TACGGATAGACCCACC-1	CEU
TACGGATAGCGGCTTC-1	YRI
TACGGATAGTGGGCTA-1	YRI
TACGGATCAGCCAATT-1	CEU
TACGGATCATGGAATA-1	CEU
TACGGATCATTCTCAT-1	CEU
TACGGATCATTGCGGC-1	YRI
TACGGATGTACAGCAG-1	YRI
TACGGATGTCAATACC-1	YRI
TACGGATGTCGCTTTC-1	YRI
TACGGATGTGGCAAAC-1	YRI
TACGGATGTTACGTCA-1	CEU
TACGGATGTTGCCTCT-1	CEU
TACGGATTCCCTTGTG-1	YRI
TACGGATTCCTATGTT-1	YRI
TACGGGCAGCGCTTAT-1	YRI
TACGGGCAGTGTCTCA-1	YRI
TACGGGCCAAGAGTCG-1	YRI
TACGGGCCAGCCTATA-1	YRI
TACGGGCCATTGGCGC-1	YRI
TACGGGCGTCAGATAA-1	YRI
TACGGGCGTGCACTTA-1	YRI
TACGGTAAGGCAAAGA-1	YRI
TACGGTAAGTGTTGAA-1	CEU
TACGGTACAATAACGA-1	YRI
TACGGTACATGCCACG-1	YRI
TACGGTAGTCCGTTAA-1	YRI
TACGGTAGTCGACTGC-1	CEU
TACGGTAGTCTAAACC-1	YRI
TACGGTATCGGCGCTA-1	YRI
TACTCATAGTGTGAAT-1	YRI
TACTCATCACATAACC-1	CEU
TACTCATGTCGTGGCT-1	YRI
TACTCATGTTCGAATC-1	CEU
TACTCATTCAGTTTGG-1	CEU
TACTCATTCGAATCCA-1	CEU
TACTCATTCGTAGATC-1	YRI
TACTCATTCTGAAAGA-1	YRI
TACTCGCAGACTGGGT-1	YRI
TACTCGCAGATGTCGG-1	CEU
TACTCGCAGCTAAACA-1	CEU
TACTCGCAGGCCCTTG-1	YRI
TACTCGCAGGTTACCT-1	YRI
TACTCGCCAGGCAGTA-1	YRI
TACTCGCCATACCATG-1	CEU
TACTCGCCATGTAGTC-1	YRI
TACTCGCGTACCAGTT-1	CEU
TACTCGCGTGTGCGTC-1	CEU
TACTCGCGTTATGTGC-1	CEU
TACTCGCGTTCAGGCC-1	CEU
TACTCGCTCACGCATA-1	CEU
TACTCGCTCAGCTCTC-1	YRI
TACTCGCTCAGCTGGC-1	YRI
TACTTACAGCGAAGGG-1	CEU
TACTTACCAGCGAACA-1	YRI
TACTTACGTAAACGCG-1	CEU
TACTTACGTAAATGTG-1	YRI
TACTTACGTAATAGCA-1	CEU
TACTTACGTACAGACG-1	YRI
TACTTACGTACTCTCC-1	YRI
TACTTACGTCGCGTGT-1	YRI
TACTTACTCATAACCG-1	YRI
TACTTACTCATGTGGT-1	CEU
TACTTGTAGTGAAGTT-1	CEU
TACTTGTCAAGAGTCG-1	YRI
TACTTGTCAGATTGCT-1	YRI
TACTTGTCAGGTCGTC-1	YRI
TACTTGTCATCCTAGA-1	CEU
TACTTGTGTAAATGTG-1	YRI
TACTTGTGTAGCTAAA-1	CEU
TACTTGTGTCATATGC-1	YRI
TACTTGTGTGACGCCT-1	YRI
TACTTGTGTGCATCTA-1	YRI
TACTTGTGTTGTCTTT-1	CEU
TACTTGTGTTGTGGCC-1	YRI
TACTTGTTCTTGTATC-1	YRI
TAGACCAAGCCGGTAA-1	YRI
TAGACCAAGGCGCTCT-1	YRI
TAGACCAAGGCTAGAC-1	YRI
TAGACCAAGTATTGGA-1	YRI
TAGACCACACCCTATC-1	YRI
TAGACCACATGCCTTC-1	YRI
TAGACCAGTAGGGACT-1	YRI
TAGACCAGTATATGAG-1	CEU
TAGACCAGTCGCGAAA-1	YRI
TAGACCAGTTGCTCCT-1	YRI
TAGACCATCAACACGT-1	CEU
TAGACCATCACAAACC-1	CEU
TAGACCATCGCCAAAT-1	CEU
TAGACCATCGTTACGA-1	YRI
TAGACCATCTCTAGGA-1	CEU
TAGAGCTAGCCTTGAT-1	YRI
TAGAGCTCAGGGTTAG-1	YRI
TAGAGCTCATTATCTC-1	YRI
TAGAGCTGTACTTAGC-1	CEU
TAGAGCTGTAGCGTAG-1	YRI
TAGAGCTGTCAGAATA-1	YRI
TAGAGCTGTCAGCTAT-1	CEU
TAGAGCTGTCCGTGAC-1	YRI
TAGAGCTGTTAAGAAC-1	YRI
TAGAGCTGTTCCAACA-1	YRI
TAGAGCTGTTGGTTTG-1	CEU
TAGAGCTTCAATAAGG-1	YRI
TAGAGCTTCATCTGCC-1	YRI
TAGCCGGAGATGGGTC-1	YRI
TAGCCGGAGCATGGCA-1	CEU
TAGCCGGAGCTATGCT-1	YRI
TAGCCGGAGTCGCCGT-1	YRI
TAGCCGGCAAGTCATC-1	YRI
TAGCCGGCACGAAGCA-1	CEU
TAGCCGGCAGATGGGT-1	YRI
TAGCCGGCAGTCTTCC-1	YRI
TAGCCGGCATGTCCTC-1	CEU
TAGCCGGCATTGGGCC-1	CEU
TAGCCGGGTTCTGTTT-1	YRI
TAGCCGGTCACAACGT-1	YRI
TAGCCGGTCAGTGTTG-1	CEU
TAGGCATAGAGGTAGA-1	YRI
TAGGCATAGCAGGCTA-1	YRI
TAGGCATAGGCTAGAC-1	CEU
TAGGCATAGTGAAGAG-1	CEU
TAGGCATCAATAGAGT-1	CEU
TAGGCATCACAACTGT-1	YRI
TAGGCATCAGCCACCA-1	CEU
TAGGCATCAGTGGAGT-1	YRI
TAGGCATGTCCTCTTG-1	YRI
TAGGCATGTCTGATTG-1	YRI
TAGGCATGTGCAACGA-1	YRI
TAGGCATGTGTCAATC-1	YRI
TAGGCATGTTCAACCA-1	CEU
TAGGCATGTTCTGAAC-1	YRI
TAGGCATTCAAACCGT-1	CEU
TAGGCATTCAGCGACC-1	CEU
TAGGCATTCTTTACAC-1	YRI
TAGTGGTAGCACCGTC-1	CEU
TAGTGGTAGCGATCCC-1	YRI
TAGTGGTAGCGGATCA-1	YRI
TAGTGGTAGCTGCAAG-1	CEU
TAGTGGTAGGTGATAT-1	CEU
TAGTGGTAGTAGCCGA-1	CEU
TAGTGGTCAGCTGTGC-1	YRI
TAGTGGTCATTCGACA-1	YRI
TAGTGGTGTCACCTAA-1	YRI
TAGTGGTGTCTCTTAT-1	YRI
TAGTGGTGTGCCTTGG-1	CEU
TAGTGGTGTTCCACGG-1	CEU
TAGTGGTGTTTGTGTG-1	CEU
TAGTGGTTCGTCCGTT-1	YRI
TAGTTGGCAACACGCC-1	YRI
TAGTTGGCACTACAGT-1	YRI
TAGTTGGCAGCTTAAC-1	CEU
TAGTTGGCAGGTGGAT-1	YRI
TAGTTGGCATCGGACC-1	YRI
TAGTTGGGTCCCGACA-1	YRI
TAGTTGGGTCGCTTTC-1	YRI
TAGTTGGTCCCGACTT-1	YRI
TAGTTGGTCGCTTAGA-1	CEU
TAGTTGGTCTTAGAGC-1	CEU
TAGTTGGTCTTGTACT-1	YRI
TAGTTGGTCTTGTTTG-1	CEU
TATCAGGAGGAACTGC-1	CEU
TATCAGGAGGCTCTTA-1	YRI
TATCAGGAGTACCGGA-1	YRI
TATCAGGAGTAGGTGC-1	CEU
TATCAGGCAAGAGGCT-1	CEU
TATCAGGCATCACGAT-1	CEU
TATCAGGCATTAACCG-1	YRI
TATCAGGGTAAGAGGA-1	YRI
TATCAGGGTAAGGATT-1	CEU
TATCAGGGTACACCGC-1	YRI
TATCAGGGTACCAGTT-1	YRI
TATCAGGGTATTCTCT-1	CEU
TATCAGGGTCGTGGCT-1	CEU
TATCAGGGTTTACTCT-1	YRI
TATCAGGTCATGGTCA-1	CEU
TATCTCAAGACAGACC-1	CEU
TATCTCAAGACTAGGC-1	CEU
TATCTCAAGAGGTTGC-1	YRI
TATCTCAAGCCAGTTT-1	CEU
TATCTCAAGCCCTAAT-1	CEU
TATCTCAAGGTAAACT-1	YRI
TATCTCACAATGCCAT-1	CEU
TATCTCACATAAGACA-1	YRI
TATCTCACATGACGGA-1	CEU
TATCTCATCAAGGTAA-1	CEU
TATCTCATCAGAGACG-1	YRI
TATGCCCAGCGATATA-1	CEU
TATGCCCAGGATGCGT-1	YRI
TATGCCCCAAACCTAC-1	YRI
TATGCCCCAAGCTGGA-1	CEU
TATGCCCCACCGCTAG-1	CEU
TATGCCCCACTGCCAG-1	YRI
TATGCCCCAGCTTAAC-1	YRI
TATGCCCCATCGGACC-1	YRI
TATGCCCCATGGTAGG-1	YRI
TATGCCCGTGAGTGAC-1	CEU
TATGCCCGTGCCTGCA-1	CEU
TATGCCCGTTACTGAC-1	YRI
TATGCCCTCACAACGT-1	YRI
TATGCCCTCACGAAGG-1	YRI
TATGCCCTCACTCCTG-1	YRI
TATGCCCTCACTTATC-1	YRI
TATGCCCTCGTGGGAA-1	YRI
TATGCCCTCTCTGAGA-1	YRI
TATGCCCTCTGTCTAT-1	CEU
TATTACCAGATGTGGC-1	CEU
TATTACCAGCTCCCAG-1	CEU
TATTACCAGGTGATTA-1	YRI
TATTACCCAAGAGGCT-1	YRI
TATTACCCACCCTATC-1	YRI
TATTACCCACTCAGGC-1	CEU
TATTACCGTCGATTGT-1	CEU
TATTACCGTGGAAAGA-1	YRI
TATTACCTCGTACCGG-1	YRI
TATTACCTCTGTCTCG-1	CEU
TCAACGAAGGTGCTTT-1	YRI
TCAACGACAAACTGCT-1	YRI
TCAACGACACATCCGG-1	YRI
TCAACGACACTGTTAG-1	YRI
TCAACGACAGACGCCT-1	CEU
TCAACGAGTAAGTGGC-1	CEU
TCAACGAGTGGTAACG-1	CEU
TCAACGAGTTCGCGAC-1	YRI
TCAACGATCAACACCA-1	YRI
TCAACGATCACGGTTA-1	CEU
TCAACGATCAGCTTAG-1	YRI
TCAACGATCTCGCTTG-1	YRI
TCAACGATCTTATCTG-1	YRI
TCAATCTAGAACTCGG-1	YRI
TCAATCTAGACTTTCG-1	YRI
TCAATCTAGCTAGTCT-1	CEU
TCAATCTAGGGTTTCT-1	YRI
TCAATCTAGGTGCAAC-1	CEU
TCAATCTAGGTGCTTT-1	YRI
TCAATCTAGTACGACG-1	CEU
TCAATCTCAGACAAGC-1	YRI
TCAATCTCATTCACTT-1	YRI
TCAATCTGTAAGAGGA-1	CEU
TCAATCTGTAGATTAG-1	YRI
TCAATCTGTTCAACCA-1	CEU
TCAATCTTCCGTAGTA-1	YRI
TCACAAGAGTCCGGTC-1	YRI
TCACAAGAGTGGTAGC-1	YRI
TCACAAGAGTTTAGGA-1	YRI
TCACAAGCAAGTTGTC-1	CEU
TCACAAGCAGTATAAG-1	CEU
TCACAAGCATAGAAAC-1	YRI
TCACAAGCATTGGGCC-1	CEU
TCACAAGGTCCAGTTA-1	CEU
TCACAAGGTTTAAGCC-1	YRI
TCACAAGGTTTGCATG-1	YRI
TCACAAGTCAATCACG-1	YRI
TCACAAGTCTCCCTGA-1	CEU
TCACGAAAGAGCCTAG-1	CEU
TCACGAAAGTTCGATC-1	YRI
TCACGAACATTTCACT-1	CEU
TCACGAAGTAGCACGA-1	CEU
TCACGAAGTAGCGCAA-1	YRI
TCACGAAGTAGCGTAG-1	YRI
TCACGAAGTCTAGCGC-1	CEU
TCACGAAGTCTCTCGT-1	YRI
TCACGAATCGAATGCT-1	YRI
TCACGAATCTTCATGT-1	YRI
TCAGATGCACATAACC-1	YRI
TCAGATGCACATCTTT-1	CEU
TCAGATGGTAGCCTCG-1	CEU
TCAGATGGTGCTGTAT-1	YRI
TCAGATGGTTCTGTTT-1	YRI
TCAGATGTCAGCTTAG-1	YRI
TCAGATGTCCCTCTTT-1	YRI
TCAGATGTCTGGGCCA-1	YRI
TCAGCAACAACTGCTA-1	CEU
TCAGCAACAGGTCCAC-1	CEU
TCAGCAAGTACAGTTC-1	CEU
TCAGCAAGTCACACGC-1	YRI
TCAGCAAGTCTCCATC-1	YRI
TCAGCAAGTTCAGTAC-1	YRI
TCAGCAATCTAAGCCA-1	CEU
TCAGCTCAGCCGATTT-1	CEU
TCAGCTCAGCTGCCCA-1	CEU
TCAGCTCAGGCTAGCA-1	YRI
TCAGCTCGTCCAGTGC-1	YRI
TCAGCTCGTGCACGAA-1	CEU
TCAGCTCGTGTGAAAT-1	CEU
TCAGCTCGTTGGACCC-1	YRI
TCAGCTCGTTTGGGCC-1	YRI
TCAGCTCTCGAGGTAG-1	YRI
TCAGGATAGACCTTTG-1	YRI
TCAGGATAGACTTGAA-1	YRI
TCAGGATAGATCCCAT-1	YRI
TCAGGATAGATGTTAG-1	CEU
TCAGGATAGCTTCGCG-1	CEU
TCAGGATAGGGATCTG-1	CEU
TCAGGATAGTACTTGC-1	YRI
TCAGGATAGTGTACGG-1	YRI
TCAGGATCAATCCAAC-1	YRI
TCAGGATCACACGCTG-1	YRI
TCAGGATCACATGGGA-1	CEU
TCAGGATCACGAAAGC-1	YRI
TCAGGATCACTGTCGG-1	YRI
TCAGGATCAGCTCCGA-1	CEU
TCAGGATGTCGCATAT-1	YRI
TCAGGATGTGCACTTA-1	YRI
TCAGGATTCACCATAG-1	YRI
TCAGGATTCCACGTGG-1	YRI
TCAGGTAAGGCTAGCA-1	CEU
TCAGGTAAGGGAACGG-1	CEU
TCAGGTAAGGTCATCT-1	CEU
TCAGGTAAGTCATCCA-1	CEU
TCAGGTAAGTGGACGT-1	CEU
TCAGGTAAGTGTCCAT-1	YRI
TCAGGTACAAGCGTAG-1	YRI
TCAGGTACACCTCGTT-1	YRI
TCAGGTACAGTCCTTC-1	YRI
TCAGGTAGTAGCTGCC-1	YRI
TCAGGTAGTCCTCTTG-1	YRI
TCAGGTAGTCGCTTTC-1	YRI
TCAGGTAGTTCCACAA-1	CEU
TCAGGTATCAATCACG-1	CEU
TCAGGTATCACTTCAT-1	YRI
TCAGGTATCCTATGTT-1	CEU
TCATTACAGCCAGTAG-1	YRI
TCATTACAGTGTTTGC-1	CEU
TCATTACAGTTCGATC-1	CEU
TCATTACCATTCTTAC-1	CEU
TCATTACGTTAAGACA-1	YRI
TCATTACGTTTGGGCC-1	CEU
TCATTACTCAGCTGGC-1	YRI
TCATTACTCATAGCAC-1	YRI
TCATTACTCCGTCATC-1	YRI
TCATTACTCTCCAACC-1	YRI
TCATTTGAGCTGTCTA-1	CEU
TCATTTGAGTAGCCGA-1	CEU
TCATTTGAGTGGACGT-1	YRI
TCATTTGCAGGACGTA-1	YRI
TCATTTGCAGGGAGAG-1	YRI
TCATTTGCATTAGCCA-1	CEU
TCATTTGGTCAGAGGT-1	YRI
TCATTTGGTCGTCTTC-1	CEU
TCATTTGGTTCGTGAT-1	CEU
TCATTTGGTTTGTGTG-1	YRI
TCATTTGTCAAGAAGT-1	CEU
TCATTTGTCAGAGGTG-1	YRI
TCATTTGTCAGTACGT-1	YRI
TCATTTGTCATCTGCC-1	YRI
TCATTTGTCTATCCCG-1	CEU
TCATTTGTCTTCAACT-1	YRI
TCATTTGTCTTTAGGG-1	CEU
TCCACACAGACAAAGG-1	CEU
TCCACACAGCTAAGAT-1	YRI
TCCACACAGTGTACTC-1	YRI
TCCACACCAACGCACC-1	CEU
TCCACACCAAGCCGCT-1	YRI
TCCACACCACTTAAGC-1	YRI
TCCACACCAGGCGATA-1	CEU
TCCACACCATCACCCT-1	YRI
TCCACACGTACCGTAT-1	YRI
TCCACACTCAGTACGT-1	CEU
TCCACACTCATCGATG-1	YRI
TCCACACTCATTCACT-1	YRI
TCCACACTCCTCATTA-1	YRI
TCCCGATAGCGGATCA-1	YRI
TCCCGATAGCTACCTA-1	YRI
TCCCGATCATGAGCGA-1	YRI
TCCCGATGTCAGGACA-1	YRI
TCCCGATGTGACCAAG-1	CEU
TCCCGATTCAACCATG-1	YRI
TCCCGATTCACTGGGC-1	YRI
TCCCGATTCCAAACTG-1	CEU
TCCCGATTCCTCAATT-1	YRI
TCCCGATTCTCTAAGG-1	YRI
TCGAGGCCAATAGAGT-1	CEU
TCGAGGCCAATGGACG-1	CEU
TCGAGGCCACCACCAG-1	YRI
TCGAGGCCACGTTGGC-1	CEU
TCGAGGCCATAAAGGT-1	YRI
TCGAGGCCATACGCTA-1	CEU
TCGAGGCGTAGCGTGA-1	CEU
TCGAGGCGTCAAACTC-1	YRI
TCGAGGCGTGTGAAAT-1	YRI
TCGAGGCGTGTGGCTC-1	CEU
TCGAGGCGTTGCCTCT-1	YRI
TCGAGGCTCCTAGTGA-1	YRI
TCGAGGCTCTAACTTC-1	YRI
TCGCGAGAGGAATGGA-1	YRI
TCGCGAGAGTCTCAAC-1	CEU
TCGCGAGAGTGGACGT-1	YRI
TCGCGAGCAATCCAAC-1	YRI
TCGCGAGCACGAAATA-1	CEU
TCGCGAGCATAAGACA-1	CEU
TCGCGAGCATATGAGA-1	CEU
TCGCGAGGTCTCTTTA-1	YRI
TCGCGAGGTTCGAATC-1	CEU
TCGCGAGTCACATGCA-1	CEU
TCGCGAGTCCAAACTG-1	CEU
TCGCGAGTCGCGTAGC-1	YRI
TCGCGAGTCGGAATCT-1	YRI
TCGCGAGTCGGTCCGA-1	YRI
TCGCGAGTCTGATTCT-1	YRI
TCGCGTTAGAAGGTGA-1	YRI
TCGCGTTAGAATGTGT-1	YRI
TCGCGTTAGACTAAGT-1	YRI
TCGCGTTAGGCGTACA-1	CEU
TCGCGTTAGGTGCTAG-1	YRI
TCGCGTTCAGCATACT-1	CEU
TCGCGTTGTACCTACA-1	YRI
TCGCGTTGTCCGAATT-1	CEU
TCGCGTTGTTGGGACA-1	YRI
TCGCGTTGTTGTGGCC-1	YRI
TCGGGACAGAACAACT-1	CEU
TCGGGACAGTGCAAGC-1	YRI
TCGGGACCAAACGTGG-1	YRI
TCGGGACCAAAGGTGC-1	YRI
TCGGGACCAGCTTAAC-1	YRI
TCGGGACCAGGGTATG-1	CEU
TCGGGACGTAATCGTC-1	CEU
TCGGGACGTACTTAGC-1	YRI
TCGGGACGTCAGAGGT-1	YRI
TCGGGACGTGCAACTT-1	YRI
TCGGGACGTGTTGAGG-1	CEU
TCGGGACGTTAGAACA-1	YRI
TCGGGACTCAACTCTT-1	CEU
TCGGGACTCATACGGT-1	CEU
TCGGGACTCTCGGACG-1	CEU
TCGGTAAAGACTTTCG-1	CEU
TCGGTAAAGGTGTGGT-1	YRI
TCGGTAACAAGTAATG-1	YRI
TCGGTAACAATGAATG-1	CEU
TCGGTAACACACGCTG-1	YRI
TCGGTAACACTGTTAG-1	YRI
TCGGTAACATACAGCT-1	CEU
TCGGTAACATAGGATA-1	YRI
TCGGTAAGTCCTAGCG-1	YRI
TCGGTAAGTCTCAACA-1	CEU
TCGGTAAGTGGACGAT-1	YRI
TCGGTAAGTTGATTGC-1	YRI
TCGGTAATCACGACTA-1	CEU
TCGGTAATCAGCTCTC-1	YRI
TCGGTAATCCCATTTA-1	YRI
TCGGTAATCCGCGCAA-1	CEU
TCGGTAATCCGCGGTA-1	YRI
TCGGTAATCGGCTACG-1	YRI
TCGTACCAGATAGTCA-1	YRI
TCGTACCAGCTAGTGG-1	CEU
TCGTACCAGGCAGGTT-1	YRI
TCGTACCAGGGAGTAA-1	CEU
TCGTACCAGTCATGCT-1	CEU
TCGTACCAGTTATCGC-1	CEU
TCGTACCCAGCTCGCA-1	CEU
TCGTACCCAGCTGCTG-1	YRI
TCGTACCCAGCTGTAT-1	YRI
TCGTACCCAGGATTGG-1	YRI
TCGTACCCAGTTCATG-1	CEU
TCGTACCCAGTTCCCT-1	YRI
TCGTACCCATACTACG-1	YRI
TCGTACCGTGCACCAC-1	CEU
TCGTACCGTGTGGCTC-1	YRI
TCGTACCTCCATGAGT-1	YRI
TCGTACCTCGCGATCG-1	CEU
TCGTACCTCGGACAAG-1	YRI
TCGTACCTCTGTCTAT-1	YRI
TCGTACCTCTTGCATT-1	CEU
TCGTAGAAGCTCCTTC-1	CEU
TCGTAGAAGTGGGTTG-1	YRI
TCGTAGACAGGATTGG-1	CEU
TCGTAGACATCGATTG-1	CEU
TCGTAGAGTCGCGAAA-1	CEU
TCGTAGAGTTCAGGCC-1	CEU
TCGTAGAGTTCGTCTC-1	YRI
TCGTAGATCCAAATGC-1	YRI
TCGTAGATCCAAGTAC-1	YRI
TCTATTGAGCAGCGTA-1	YRI
TCTATTGAGCCAGAAC-1	CEU
TCTATTGAGGCCATAG-1	YRI
TCTATTGCACGGTAAG-1	YRI
TCTATTGCAGAGCCAA-1	CEU
TCTATTGGTATAGGGC-1	YRI
TCTATTGGTCTAGTGT-1	CEU
TCTATTGGTGGTGTAG-1	YRI
TCTATTGGTTAAGGGC-1	YRI
TCTATTGTCTTATCTG-1	YRI
TCTCATAAGCTGCAAG-1	CEU
TCTCATAAGGGAACGG-1	YRI
TCTCATACAACAACCT-1	YRI
TCTCATACACATCCGG-1	YRI
TCTCATACACCGTTGG-1	CEU
TCTCATACAGGGTTAG-1	YRI
TCTCATAGTCGTGGCT-1	YRI
TCTCATAGTGATAAAC-1	CEU
TCTCATAGTTCGGCAC-1	CEU
TCTCATATCCACGTTC-1	YRI
TCTCATATCCGGCACA-1	CEU
TCTCATATCTCGCTTG-1	CEU
TCTCATATCTTGACGA-1	CEU
TCTCTAAAGAAGAAGC-1	CEU
TCTCTAAAGACAGGCT-1	CEU
TCTCTAAAGCCAGAAC-1	CEU
TCTCTAAAGCGTAGTG-1	YRI
TCTCTAAAGCTATGCT-1	CEU
TCTCTAAAGTACACCT-1	YRI
TCTCTAACACGCATCG-1	YRI
TCTCTAACATATGAGA-1	YRI
TCTCTAAGTCAATGTC-1	YRI
TCTCTAAGTCGCGTGT-1	CEU
TCTCTAAGTTAAAGTG-1	YRI
TCTCTAATCACATGCA-1	YRI
TCTCTAATCACCGTAA-1	YRI
TCTCTAATCCTGCAGG-1	YRI
TCTCTAATCTAACTCT-1	YRI
TCTCTAATCTACTCAT-1	CEU
TCTCTAATCTGATTCT-1	YRI
TCTGAGAGTACCGCTG-1	YRI
TCTGAGAGTATAGGTA-1	YRI
TCTGAGAGTTCACCTC-1	YRI
TCTGAGATCCGGCACA-1	YRI
TCTGAGATCGTTACGA-1	YRI
TCTGAGATCTCACATT-1	YRI
TCTGGAAAGATGTGGC-1	CEU
TCTGGAAAGCGATATA-1	CEU
TCTGGAAAGTGGGTTG-1	YRI
TCTGGAAAGTGTCCAT-1	CEU
TCTGGAACAGTCAGAG-1	YRI
TCTGGAAGTCCAAGTT-1	CEU
TCTGGAATCCTTTCGG-1	CEU
TCTGGAATCTGCCCTA-1	YRI
TCTGGAATCTGTACGA-1	YRI
TCTGGAATCTTGCATT-1	CEU
TCTTCGGAGAGCAATT-1	YRI
TCTTCGGAGCTGAACG-1	YRI
TCTTCGGAGTAGGTGC-1	YRI
TCTTCGGAGTCCCACG-1	YRI
TCTTCGGCATCGGTTA-1	CEU
TCTTCGGCATCTCCCA-1	CEU
TCTTCGGCATGCTAGT-1	YRI
TCTTCGGGTAAGTTCC-1	CEU
TCTTCGGGTACAAGTA-1	CEU
TCTTCGGGTATGAATG-1	YRI
TCTTCGGGTCAGATAA-1	YRI
TCTTCGGTCATGTCTT-1	YRI
TCTTCGGTCCAATGGT-1	YRI
TCTTCGGTCGGGAGTA-1	CEU
TCTTCGGTCGTTTGCC-1	YRI
TCTTTCCAGACTAGAT-1	YRI
TCTTTCCAGATATACG-1	YRI
TCTTTCCCACATAACC-1	CEU
TCTTTCCCACATCCGG-1	CEU
TCTTTCCCAGGGTTAG-1	YRI
TCTTTCCCATGTCCTC-1	CEU
TCTTTCCGTCAGGACA-1	CEU
TCTTTCCGTCGAACAG-1	CEU
TCTTTCCTCCCTTGTG-1	YRI
TCTTTCCTCGGCGGTT-1	YRI
TCTTTCCTCTAACTCT-1	CEU
TGAAAGACATTTCAGG-1	YRI
TGAAAGAGTACCATCA-1	YRI
TGAAAGAGTCCGAAGA-1	YRI
TGAAAGAGTGATGCCC-1	YRI
TGAAAGATCCACGTGG-1	YRI
TGAAAGATCGTGACAT-1	CEU
TGAAAGATCTGTCCGT-1	CEU
TGACAACAGAGAGCTC-1	YRI
TGACAACAGTGGTCCC-1	YRI
TGACAACAGTGTCTCA-1	YRI
TGACAACCAAATACAG-1	YRI
TGACAACCACAACGCC-1	YRI
TGACAACCACAGGTTT-1	YRI
TGACAACCACCTATCC-1	CEU
TGACAACCAGCCTGTG-1	YRI
TGACAACCATACTCTT-1	YRI
TGACAACCATGACATC-1	CEU
TGACAACGTCGCATAT-1	CEU
TGACAACGTGGCAAAC-1	YRI
TGACAACTCCATGCTC-1	YRI
TGACAACTCGGTGTTA-1	YRI
TGACGGCAGTGAACAT-1	YRI
TGACGGCGTAAGCACG-1	YRI
TGACGGCGTATGAATG-1	YRI
TGACGGCGTTCACCTC-1	CEU
TGACGGCTCGCCAGCA-1	YRI
TGACTAGAGAATCTCC-1	CEU
TGACTAGAGTCTCGGC-1	CEU
TGACTAGCAATGTAAG-1	YRI
TGACTAGCACCGCTAG-1	YRI
TGACTAGCAGCCACCA-1	CEU
TGACTAGCATTAGGCT-1	CEU
TGACTAGGTACTTCTT-1	YRI
TGACTAGGTAGTACCT-1	CEU
TGACTAGGTGCCTTGG-1	CEU
TGACTAGGTGTGAAAT-1	YRI
TGACTAGGTTACAGAA-1	YRI
TGACTAGTCCCTTGCA-1	YRI
TGACTAGTCTTGTTTG-1	YRI
TGACTTTAGAGACTTA-1	YRI
TGACTTTAGCCACTAT-1	YRI
TGACTTTAGTTCGCGC-1	YRI
TGACTTTCAAGGGTCA-1	YRI
TGACTTTCAATCGGTT-1	CEU
TGACTTTCAGTGAGTG-1	YRI
TGACTTTCATATGCTG-1	YRI
TGACTTTCATGATCCA-1	YRI
TGACTTTGTAAACACA-1	YRI
TGACTTTGTAGCGTGA-1	CEU
TGACTTTGTCCAACTA-1	YRI
TGACTTTGTTACTGAC-1	CEU
TGACTTTGTTCTGGTA-1	YRI
TGACTTTGTTGTGGAG-1	YRI
TGACTTTTCGGATGGA-1	YRI
TGAGAGGAGAGGGATA-1	CEU
TGAGAGGAGATCACGG-1	YRI
TGAGAGGAGATCCCGC-1	CEU
TGAGAGGAGTGGGCTA-1	YRI
TGAGAGGCAAAGGTGC-1	CEU
TGAGAGGCAATAGCGG-1	CEU
TGAGAGGCACGTCTCT-1	YRI
TGAGAGGCAGCTTCGG-1	YRI
TGAGAGGCAGGTGGAT-1	YRI
TGAGAGGCAGTAGAGC-1	CEU
TGAGAGGCATGTAAGA-1	CEU
TGAGAGGGTCCCGACA-1	YRI
TGAGAGGGTCGCATCG-1	CEU
TGAGCATAGTGTCCAT-1	CEU
TGAGCATCAAGTAGTA-1	YRI
TGAGCATCATCCTTGC-1	YRI
TGAGCATCATGAACCT-1	YRI
TGAGCATCATGGTCAT-1	YRI
TGAGCATCATTTCAGG-1	YRI
TGAGCATGTCAGAATA-1	YRI
TGAGCATGTGGCCCTA-1	YRI
TGAGCATTCCCTAACC-1	CEU
TGAGCATTCCGCATCT-1	YRI
TGAGCCGAGCATGGCA-1	YRI
TGAGCCGCAAACCCAT-1	YRI
TGAGCCGGTCTACCTC-1	YRI
TGAGCCGGTTGGGACA-1	YRI
TGAGGGAAGACAGACC-1	YRI
TGAGGGAAGACCACGA-1	YRI
TGAGGGAAGAGGACGG-1	YRI
TGAGGGAAGATCGGGT-1	YRI
TGAGGGAAGCGTCAAG-1	CEU
TGAGGGAAGGCTAGAC-1	CEU
TGAGGGAAGTCTCGGC-1	YRI
TGAGGGACACAGACAG-1	YRI
TGAGGGACACTGCCAG-1	CEU
TGAGGGACATGACATC-1	CEU
TGAGGGACATTGCGGC-1	CEU
TGAGGGAGTTGACGTT-1	CEU
TGAGGGATCCTATTCA-1	CEU
TGAGGGATCGCCGTGA-1	YRI
TGAGGGATCGGAAATA-1	YRI
TGAGGGATCGGCGGTT-1	CEU
TGATTTCAGCGGATCA-1	CEU
TGATTTCCACCTGGTG-1	YRI
TGATTTCCAGCCAGAA-1	CEU
TGATTTCCATTCACTT-1	YRI
TGATTTCGTACCGCTG-1	YRI
TGATTTCGTTACGCGC-1	YRI
TGATTTCTCCTTGACC-1	YRI
TGATTTCTCGCCTGTT-1	CEU
TGCACCTAGAGCCCAA-1	YRI
TGCACCTAGCATGGCA-1	CEU
TGCACCTAGGTGGGTT-1	YRI
TGCACCTCAATAGAGT-1	YRI
TGCACCTCACAACTGT-1	CEU
TGCACCTCACAAGACG-1	YRI
TGCACCTCAGACTCGC-1	CEU
TGCACCTCAGGTCCAC-1	CEU
TGCACCTGTAAACCTC-1	CEU
TGCACCTGTACCCAAT-1	YRI
TGCACCTGTAGAGCTG-1	YRI
TGCACCTGTCAGGACA-1	CEU
TGCACCTTCAATCACG-1	CEU
TGCACCTTCACGAAGG-1	YRI
TGCACCTTCACGACTA-1	YRI
TGCACCTTCGCTGATA-1	CEU
TGCACCTTCTACTTAC-1	CEU
TGCCAAAAGGCTAGAC-1	CEU
TGCCAAACATCACGAT-1	YRI
TGCCAAAGTCGGCTCA-1	YRI
TGCCAAAGTCTCCCTA-1	YRI
TGCCAAAGTCTCGTTC-1	YRI
TGCCAAAGTGCCTTGG-1	CEU
TGCCAAATCAAGCCTA-1	YRI
TGCCAAATCAGTTAGC-1	CEU
TGCCAAATCCTCATTA-1	CEU
TGCCAAATCGACAGCC-1	YRI
TGCCCATAGAATTCCC-1	YRI
TGCCCATAGACCCACC-1	YRI
TGCCCATAGAGACGAA-1	CEU
TGCCCATAGAGGTTGC-1	CEU
TGCCCATCAACGATCT-1	YRI
TGCCCATCAGGAACGT-1	CEU
TGCCCATCAGGAATCG-1	YRI
TGCCCATGTAACGCGA-1	CEU
TGCCCATGTAAGAGGA-1	YRI
TGCCCATGTGCTTCTC-1	YRI
TGCCCATGTGTCGCTG-1	CEU
TGCCCATGTTCGGCAC-1	YRI
TGCCCATTCCTGCTTG-1	CEU
TGCCCTAAGCTCCTTC-1	YRI
TGCCCTAAGGGCTTCC-1	CEU
TGCCCTAAGGTGTGGT-1	YRI
TGCCCTACACCCATTC-1	YRI
TGCCCTACACTACAGT-1	YRI
TGCCCTACAGGGTTAG-1	YRI
TGCCCTACATAAAGGT-1	CEU
TGCCCTACATGTTGAC-1	CEU
TGCCCTAGTACCGGCT-1	CEU
TGCCCTAGTCTACCTC-1	YRI
TGCCCTAGTGAGGCTA-1	YRI
TGCCCTATCAGGCGAA-1	YRI
TGCGCAGAGCATCATC-1	YRI
TGCGCAGAGGATGTAT-1	YRI
TGCGCAGCAAGGACTG-1	YRI
TGCGCAGCACAACGTT-1	CEU
TGCGCAGCAGCTTCGG-1	YRI
TGCGCAGCATGCCACG-1	CEU
TGCGCAGGTGACTACT-1	CEU
TGCGCAGGTGGTACAG-1	YRI
TGCGCAGGTGGTCTCG-1	YRI
TGCGCAGGTTATGTGC-1	CEU
TGCGCAGTCGAACGGA-1	CEU
TGCGGGTAGAATTGTG-1	YRI
TGCGGGTAGGAGTCTG-1	YRI
TGCGGGTAGTGGAGAA-1	CEU
TGCGGGTCACAGGCCT-1	CEU
TGCGGGTCACGGTAAG-1	CEU
TGCGGGTCACTGTTAG-1	CEU
TGCGGGTCAGTCAGAG-1	CEU
TGCGGGTGTCTAGTCA-1	CEU
TGCGTGGAGATCCCGC-1	CEU
TGCGTGGAGCCAGTTT-1	CEU
TGCGTGGAGTTTAGGA-1	YRI
TGCGTGGCAGCCACCA-1	YRI
TGCGTGGCATGTAAGA-1	CEU
TGCGTGGGTCGTGGCT-1	YRI
TGCGTGGGTCTCCCTA-1	YRI
TGCGTGGGTCTCGTTC-1	YRI
TGCGTGGGTTTGACAC-1	CEU
TGCGTGGTCACAAACC-1	CEU
TGCGTGGTCCACGAAT-1	CEU
TGCGTGGTCTATCCCG-1	CEU
TGCGTGGTCTTCATGT-1	YRI
TGCTACCAGATCTGAA-1	YRI
TGCTACCAGATGAGAG-1	YRI
TGCTACCCAGAGCCAA-1	YRI
TGCTACCGTGGTCCGT-1	CEU
TGCTACCGTTCCACAA-1	CEU
TGCTACCTCAGAGCTT-1	YRI
TGCTACCTCAGGCGAA-1	CEU
TGCTACCTCGGCGCTA-1	YRI
TGCTACCTCGGTGTTA-1	YRI
TGCTACCTCTCAAGTG-1	YRI
TGCTGCTAGGTCATCT-1	CEU
TGCTGCTCACATTCGA-1	YRI
TGCTGCTCATTCGACA-1	CEU
TGCTGCTGTGAGTGAC-1	YRI
TGCTGCTGTGCTTCTC-1	YRI
TGCTGCTGTTGCGTTA-1	YRI
TGCTGCTTCTTAACCT-1	YRI
TGCTGCTTCTTGCATT-1	CEU
TGGACGCAGATAGCAT-1	YRI
TGGACGCAGCAGACTG-1	CEU
TGGACGCAGCCACGTC-1	YRI
TGGACGCAGCCGGTAA-1	CEU
TGGACGCAGCCGTCGT-1	YRI
TGGACGCCACAGATTC-1	YRI
TGGACGCGTCGATTGT-1	YRI
TGGACGCTCACAACGT-1	CEU
TGGACGCTCAGCTTAG-1	YRI
TGGACGCTCCCTTGTG-1	YRI
TGGCCAGAGAGTGACC-1	YRI
TGGCCAGAGATATGGT-1	CEU
TGGCCAGAGGGAACGG-1	YRI
TGGCCAGAGTCCGTAT-1	CEU
TGGCCAGCACATCCGG-1	CEU
TGGCCAGCATAACCTG-1	YRI
TGGCCAGCATCGTCGG-1	YRI
TGGCCAGCATGAACCT-1	YRI
TGGCCAGGTAGCGTGA-1	YRI
TGGCCAGGTTGGACCC-1	YRI
TGGCCAGTCAGCACAT-1	CEU
TGGCCAGTCGTTTGCC-1	CEU
TGGCCAGTCTGCAAGT-1	CEU
TGGCCAGTCTTGTACT-1	YRI
TGGCGCAAGACAAGCC-1	CEU
TGGCGCACAATTCCTT-1	CEU
TGGCGCACACCGAAAG-1	YRI
TGGCGCACAGGACCCT-1	CEU
TGGCGCACAGTAGAGC-1	CEU
TGGCGCAGTACCGTAT-1	CEU
TGGCGCAGTCAAACTC-1	CEU
TGGCGCAGTCTAAAGA-1	YRI
TGGCGCAGTGAGTGAC-1	YRI
TGGCGCAGTTCCTCCA-1	YRI
TGGCGCATCCCACTTG-1	YRI
TGGCGCATCCCATTAT-1	YRI
TGGCGCATCGGCGCTA-1	YRI
TGGCTGGAGAAACCGC-1	YRI
TGGCTGGAGATCCTGT-1	YRI
TGGCTGGAGTACGTAA-1	YRI
TGGCTGGAGTGGTCCC-1	CEU
TGGCTGGCAAGCTGAG-1	YRI
TGGCTGGCAATGGTCT-1	CEU
TGGCTGGCACGCTTTC-1	CEU
TGGCTGGCACGGACAA-1	YRI
TGGCTGGCACGGTAGA-1	YRI
TGGCTGGCAGGTTTCA-1	CEU
TGGCTGGCAGTCACTA-1	YRI
TGGCTGGCAGTCGTGC-1	YRI
TGGCTGGGTGACGCCT-1	YRI
TGGCTGGGTTAGATGA-1	YRI
TGGCTGGGTTTGTTTC-1	YRI
TGGCTGGTCCACTCCA-1	CEU
TGGCTGGTCGAGCCCA-1	YRI
TGGCTGGTCTCCTATA-1	CEU
TGGGAAGAGCGTTCCG-1	CEU
TGGGAAGAGGTAGCCA-1	YRI
TGGGAAGCACCCTATC-1	YRI
TGGGAAGCACGGTTTA-1	CEU
TGGGAAGCAGCCACCA-1	YRI
TGGGAAGCATGACATC-1	YRI
TGGGAAGGTACCGTAT-1	CEU
TGGGAAGGTCGGGTCT-1	YRI
TGGGAAGGTCTCAACA-1	CEU
TGGGAAGGTGGGTATG-1	YRI
TGGGAAGGTTCCATGA-1	YRI
TGGGAAGTCACTTACT-1	YRI
TGGGAAGTCAGTACGT-1	YRI
TGGGAAGTCATAAAGG-1	YRI
TGGGAAGTCCCAAGTA-1	YRI
TGGGAAGTCGTAGGAG-1	YRI
TGGGCGTAGATGTAAC-1	YRI
TGGGCGTAGTACGCGA-1	YRI
TGGGCGTCAATCTGCA-1	YRI
TGGGCGTCACATCTTT-1	YRI
TGGGCGTCACCCAGTG-1	YRI
TGGGCGTCACGTTGGC-1	CEU
TGGGCGTCATAACCTG-1	CEU
TGGGCGTCATTCCTGC-1	YRI
TGGGCGTGTACAGACG-1	CEU
TGGGCGTGTATGCTTG-1	YRI
TGGGCGTGTGATAAGT-1	CEU
TGGTTAGAGAGGTAGA-1	CEU
TGGTTAGAGCACCGCT-1	YRI
TGGTTAGAGGATATAC-1	CEU
TGGTTAGAGTACACCT-1	YRI
TGGTTAGCAACGCACC-1	CEU
TGGTTAGCACTAGTAC-1	CEU
TGGTTAGGTCGCTTCT-1	CEU
TGGTTAGGTGCGCTTG-1	CEU
TGGTTAGTCGTACGGC-1	YRI
TGGTTCCAGAGCCTAG-1	YRI
TGGTTCCAGCGCTCCA-1	CEU
TGGTTCCAGTCTCAAC-1	CEU
TGGTTCCAGTCTCCTC-1	CEU
TGGTTCCAGTGGTAAT-1	CEU
TGGTTCCAGTGTCCAT-1	YRI
TGGTTCCCACCACGTG-1	CEU
TGGTTCCCACGTGAGA-1	CEU
TGGTTCCGTACCATCA-1	CEU
TGGTTCCGTGCTGTAT-1	YRI
TGGTTCCGTTGTTTGG-1	YRI
TGGTTCCGTTTAGGAA-1	YRI
TGGTTCCTCCATTCTA-1	YRI
TGGTTCCTCGCCGTGA-1	CEU
TGGTTCCTCGTCCAGG-1	YRI
TGGTTCCTCTGGAGCC-1	YRI
TGTATTCAGCCACTAT-1	YRI
TGTATTCCAAACGCGA-1	YRI
TGTATTCCATGTCTCC-1	CEU
TGTATTCCATTGGTAC-1	CEU
TGTATTCGTCAACTGT-1	CEU
TGTATTCGTCACTTCC-1	YRI
TGTATTCGTCGCTTCT-1	CEU
TGTATTCGTGCTCTTC-1	CEU
TGTATTCTCGCCAGCA-1	YRI
TGTATTCTCTCTTATG-1	YRI
TGTCCCAAGACAAAGG-1	YRI
TGTCCCAAGCCCAATT-1	YRI
TGTCCCAAGCGATGAC-1	CEU
TGTCCCAAGCGTGTCC-1	YRI
TGTCCCAAGTTTGCGT-1	YRI
TGTCCCACAAGCCGCT-1	CEU
TGTCCCACAGGTTTCA-1	YRI
TGTCCCACATCCGTGG-1	CEU
TGTCCCACATCTCCCA-1	YRI
TGTCCCACATCTCGCT-1	YRI
TGTCCCAGTCTTCAAG-1	YRI
TGTCCCAGTGACCAAG-1	YRI
TGTCCCAGTTTGGCGC-1	YRI
TGTCCCATCGATAGAA-1	YRI
TGTGGTAAGAGTGACC-1	CEU
TGTGGTAAGCAATCTC-1	YRI
TGTGGTAAGGCAGTCA-1	CEU
TGTGGTACAATCACAC-1	YRI
TGTGGTACAGGACCCT-1	YRI
TGTGGTACAGGACGTA-1	YRI
TGTGGTACATCAGTCA-1	YRI
TGTGGTACATTACCTT-1	CEU
TGTGGTAGTAACGCGA-1	YRI
TGTGGTAGTCCCTTGT-1	YRI
TGTGGTAGTCCGTCAG-1	CEU
TGTGGTAGTCCTAGCG-1	YRI
TGTGGTAGTCGTTGTA-1	YRI
TGTGGTAGTCTGATTG-1	YRI
TGTGGTATCAACACAC-1	YRI
TGTGGTATCCTTGCCA-1	CEU
TGTGGTATCGACCAGC-1	YRI
TGTGTTTAGAGTGACC-1	YRI
TGTGTTTAGCCCAGCT-1	YRI
TGTGTTTAGCGCCTTG-1	CEU
TGTGTTTAGCGTCAAG-1	CEU
TGTGTTTAGTGAACGC-1	YRI
TGTGTTTAGTGTTGAA-1	YRI
TGTGTTTCAAGCGATG-1	CEU
TGTGTTTCACGCATCG-1	YRI
TGTGTTTGTCGCGTGT-1	CEU
TGTGTTTGTGGGTCAA-1	CEU
TGTGTTTGTTACCAGT-1	YRI
TGTGTTTTCCCATTAT-1	YRI
TGTGTTTTCGTCGTTC-1	YRI
TGTTCCGAGAAGAAGC-1	CEU
TGTTCCGAGAGCTGCA-1	YRI
TGTTCCGAGCACACAG-1	CEU
TGTTCCGAGCACCGCT-1	CEU
TGTTCCGAGTGGACGT-1	YRI
TGTTCCGAGTGTTTGC-1	CEU
TGTTCCGCAACTGGCC-1	YRI
TGTTCCGCAATGTAAG-1	YRI
TGTTCCGCACCGAAAG-1	YRI
TGTTCCGCAGACGTAG-1	YRI
TGTTCCGCAGCTATTG-1	YRI
TGTTCCGGTCTTGTCC-1	YRI
TGTTCCGGTTATCGGT-1	YRI
TGTTCCGTCGTAGGTT-1	CEU
TGTTCCGTCGTTACGA-1	YRI
TGTTCCGTCTTCGGTC-1	CEU
TTAACTCAGAGTGACC-1	YRI
TTAACTCAGCACAGGT-1	YRI
TTAACTCAGCGCTCCA-1	YRI
TTAACTCCAAGCGAGT-1	CEU
TTAACTCCACAAGCCC-1	YRI
TTAACTCCAGCGTCCA-1	YRI
TTAACTCCATCACCCT-1	YRI
TTAACTCGTACCAGTT-1	CEU
TTAACTCGTCTTGCGG-1	YRI
TTAACTCGTGAGGCTA-1	CEU
TTAACTCGTTAGAACA-1	YRI
TTAACTCTCTTTAGGG-1	YRI
TTAGGACAGTAGTGCG-1	YRI
TTAGGACAGTTCGCGC-1	YRI
TTAGGACAGTTTGCGT-1	CEU
TTAGGACCAATCGGTT-1	CEU
TTAGGACCAGTATCTG-1	CEU
TTAGGACCATTACGAC-1	CEU
TTAGGACGTCTGATCA-1	YRI
TTAGGACTCCTGCAGG-1	CEU
TTAGGACTCGCCGTGA-1	CEU
TTAGGCAAGATCCCGC-1	YRI
TTAGGCAAGCCACCTG-1	YRI
TTAGGCAAGGTCGGAT-1	YRI
TTAGGCACACACCGAC-1	YRI
TTAGGCACATAGTAAG-1	YRI
TTAGGCACATGAACCT-1	YRI
TTAGGCAGTAGAGCTG-1	YRI
TTAGGCAGTCCATCCT-1	YRI
TTAGGCAGTCGCATAT-1	YRI
TTAGGCAGTCGGGTCT-1	YRI
TTAGGCATCAAACGGG-1	YRI
TTAGGCATCCAAATGC-1	CEU
TTAGGCATCCTATTCA-1	YRI
TTAGTTCAGACTAAGT-1	YRI
TTAGTTCAGAGAACAG-1	YRI
TTAGTTCAGAGTTGGC-1	CEU
TTAGTTCAGGACGAAA-1	YRI
TTAGTTCAGTCCCACG-1	YRI
TTAGTTCAGTTAACGA-1	YRI
TTAGTTCAGTTATCGC-1	CEU
TTAGTTCCACCATCCT-1	CEU
TTAGTTCCACCGATAT-1	YRI
TTAGTTCCATCCTAGA-1	CEU
TTAGTTCGTCACCCAG-1	YRI
TTAGTTCGTGAAGGCT-1	CEU
TTAGTTCGTGACGGTA-1	CEU
TTAGTTCGTTACGGAG-1	YRI
TTAGTTCGTTGATTGC-1	CEU
TTAGTTCTCAAGCCTA-1	YRI
TTAGTTCTCAGCATGT-1	CEU
TTAGTTCTCATCGATG-1	YRI
TTAGTTCTCCCGACTT-1	YRI
TTAGTTCTCCGTAGTA-1	CEU
TTAGTTCTCGCGTAGC-1	CEU
TTATGCTAGATCCCGC-1	YRI
TTATGCTAGGAATCGC-1	YRI
TTATGCTCAAATCCGT-1	YRI
TTATGCTCAAGGGTCA-1	YRI
TTATGCTCATACCATG-1	YRI
TTATGCTCATATGAGA-1	CEU
TTATGCTCATTTGCTT-1	CEU
TTATGCTGTAATAGCA-1	0
TTATGCTGTCCGTTAA-1	YRI
TTATGCTGTCGGATCC-1	YRI
TTATGCTGTCTTTCAT-1	YRI
TTATGCTGTGAGCGAT-1	CEU
TTATGCTTCAACTCTT-1	CEU
TTATGCTTCAGAAATG-1	YRI
TTATGCTTCGCCAAAT-1	CEU
TTATGCTTCGTACCGG-1	CEU
TTCCCAGAGGAGCGAG-1	YRI
TTCCCAGCAATGCCAT-1	CEU
TTCCCAGCACCGATAT-1	CEU
TTCCCAGCATGCCTAA-1	YRI
TTCCCAGCATTCCTGC-1	CEU
TTCCCAGGTAAGCACG-1	YRI
TTCCCAGGTACAGACG-1	CEU
TTCCCAGGTCTGCAAT-1	YRI
TTCCCAGGTGCACGAA-1	CEU
TTCCCAGGTGCGAAAC-1	CEU
TTCCCAGGTTAGGGTG-1	YRI
TTCCCAGGTTCGTTGA-1	CEU
TTCCCAGTCGGGAGTA-1	YRI
TTCCCAGTCTGTCTCG-1	YRI
TTCGAAGAGCTAAACA-1	YRI
TTCGAAGAGCTAAGAT-1	YRI
TTCGAAGCAAAGCAAT-1	YRI
TTCGAAGCAATCAGAA-1	YRI
TTCGAAGCACCTCGTT-1	YRI
TTCGAAGCAGGAACGT-1	CEU
TTCGAAGGTGGACGAT-1	YRI
TTCGAAGTCCCTTGTG-1	YRI
TTCGAAGTCCTTGGTC-1	YRI
TTCGAAGTCTCATTCA-1	YRI
TTCGGTCAGAAACCAT-1	CEU
TTCGGTCAGACTAGAT-1	YRI
TTCGGTCAGGCGTACA-1	CEU
TTCGGTCAGTCAAGGC-1	CEU
TTCGGTCCAATCGAAA-1	CEU
TTCGGTCCACGAAACG-1	YRI
TTCGGTCCAGACTCGC-1	CEU
TTCGGTCCAGATAATG-1	CEU
TTCGGTCCATCGATTG-1	YRI
TTCGGTCCATTTGCCC-1	CEU
TTCGGTCGTCGAGATG-1	CEU
TTCGGTCGTTGGGACA-1	CEU
TTCGGTCTCACATAGC-1	YRI
TTCGGTCTCCGAATGT-1	CEU
TTCGGTCTCTTAGAGC-1	YRI
TTCTACAAGGCTAGCA-1	CEU
TTCTACAAGTTATCGC-1	CEU
TTCTACACAATACGCT-1	CEU
TTCTACACATACGCTA-1	YRI
TTCTACACATCGATGT-1	YRI
TTCTACAGTAATAGCA-1	CEU
TTCTACAGTAGGCTGA-1	YRI
TTCTACAGTCGAATCT-1	YRI
TTCTACAGTCTCATCC-1	YRI
TTCTACAGTGCCTGTG-1	CEU
TTCTACAGTTTCGCTC-1	CEU
TTCTACATCCGCAGTG-1	YRI
TTCTCAAAGCCGTCGT-1	YRI
TTCTCAAAGCGTGTCC-1	CEU
TTCTCAAAGGCGACAT-1	YRI
TTCTCAAAGTAAGTAC-1	YRI
TTCTCAAAGTTTAGGA-1	YRI
TTCTCAACAAGGACTG-1	YRI
TTCTCAACACTAAGTC-1	YRI
TTCTCAACAGACGTAG-1	YRI
TTCTCAACAGTACACT-1	CEU
TTCTCAACATGATCCA-1	YRI
TTCTCAAGTACCCAAT-1	YRI
TTCTCAAGTAGCACGA-1	CEU
TTCTCAAGTCCAGTGC-1	YRI
TTCTCAAGTGACGGTA-1	YRI
TTCTCAAGTTAAAGAC-1	CEU
TTCTCAAGTTCCCTTG-1	CEU
TTCTCAATCGTCTGCT-1	YRI
TTCTCCTAGCCCAACC-1	YRI
TTCTCCTAGTAATCCC-1	YRI
TTCTCCTAGTGACTCT-1	YRI
TTCTCCTCAGGTCTCG-1	YRI
TTCTCCTGTAACGTTC-1	CEU
TTCTCCTGTGTTCGAT-1	CEU
TTCTCCTTCCGCGGTA-1	YRI
TTCTCCTTCCGTTGCT-1	CEU
TTCTTAGAGATGTTAG-1	YRI
TTCTTAGAGTAAGTAC-1	YRI
TTCTTAGAGTGCCAGA-1	CEU
TTCTTAGAGTGCCATT-1	YRI
TTCTTAGCACGCCAGT-1	CEU
TTCTTAGCACGGTTTA-1	CEU
TTCTTAGGTCAGAATA-1	YRI
TTCTTAGGTCCTAGCG-1	YRI
TTCTTAGTCGGTCTAA-1	YRI
TTCTTAGTCTCGCATC-1	CEU
TTGAACGAGAAGAAGC-1	YRI
TTGAACGAGACTCGGA-1	CEU
TTGAACGAGAGCTATA-1	YRI
TTGAACGAGGGTTTCT-1	YRI
TTGAACGAGTAATCCC-1	YRI
TTGAACGAGTTGTAGA-1	YRI
TTGAACGCAAACGTGG-1	YRI
TTGAACGCAACACCTA-1	YRI
TTGAACGCAGCTGTTA-1	YRI
TTGAACGCATCATCCC-1	CEU
TTGAACGGTCTCCCTA-1	YRI
TTGAACGGTTGTCGCG-1	YRI
TTGAACGGTTTGTTGG-1	YRI
TTGAACGTCATAAAGG-1	CEU
TTGAACGTCCCGGATG-1	YRI
TTGAACGTCCGCTGTT-1	CEU
TTGAACGTCGGAATCT-1	YRI
TTGACTTAGACACTAA-1	CEU
TTGACTTAGCGTTCCG-1	YRI
TTGACTTAGGGTCGAT-1	YRI
TTGACTTCAAGCCATT-1	YRI
TTGACTTCACGCGAAA-1	CEU
TTGACTTCAGGTCTCG-1	YRI
TTGACTTGTATAATGG-1	CEU
TTGACTTGTCTGATTG-1	CEU
TTGACTTGTGACCAAG-1	CEU
TTGACTTGTGGCTCCA-1	YRI
TTGACTTGTGTTTGTG-1	YRI
TTGACTTGTTCTGAAC-1	YRI
TTGACTTTCGTTGCCT-1	YRI
TTGACTTTCTCGTATT-1	YRI
TTGCCGTAGCCACGTC-1	YRI
TTGCCGTAGGAACTGC-1	CEU
TTGCCGTAGTCCAGGA-1	CEU
TTGCCGTAGTGGACGT-1	YRI
TTGCCGTAGTGGTAGC-1	YRI
TTGCCGTCAAAGAATC-1	YRI
TTGCCGTCAGCTCGAC-1	YRI
TTGCCGTCATCGGACC-1	YRI
TTGCCGTCATGCCTAA-1	CEU
TTGCCGTGTACTTCTT-1	YRI
TTGCCGTGTATATGGA-1	CEU
TTGCCGTGTCAGAAGC-1	CEU
TTGCCGTGTGCTTCTC-1	CEU
TTGCCGTGTTATCACG-1	CEU
TTGCCGTGTTGGTTTG-1	YRI
TTGCCGTTCACCTCGT-1	CEU
TTGCCGTTCTAACTCT-1	YRI
TTGCGTCAGCACACAG-1	YRI
TTGCGTCAGCACCGTC-1	YRI
TTGCGTCAGCAGCGTA-1	YRI
TTGCGTCAGCTGGAAC-1	CEU
TTGCGTCAGTGCAAGC-1	CEU
TTGCGTCCACCTCGTT-1	YRI
TTGCGTCGTATTCTCT-1	YRI
TTGCGTCGTCTGGAGA-1	YRI
TTGCGTCGTCTTCGTC-1	YRI
TTGCGTCTCATCTGTT-1	YRI
TTGCGTCTCTTTACAC-1	YRI
TTGGAACAGCCTCGTG-1	YRI
TTGGAACCACATTTCT-1	CEU
TTGGAACGTCAGAATA-1	CEU
TTGGAACGTTTGCATG-1	CEU
TTGGAACTCAGCTCGG-1	CEU
TTGGAACTCGCAAACT-1	CEU
TTGGAACTCGTAGGTT-1	YRI
TTGGAACTCTGACCTC-1	YRI
TTGGAACTCTGGCGAC-1	YRI
TTGGCAACAAGTTCTG-1	YRI
TTGGCAACACGGTAAG-1	CEU
TTGGCAACAGACAAGC-1	YRI
TTGGCAAGTACCGTAT-1	YRI
TTGGCAAGTTGTGGAG-1	YRI
TTGGCAATCAACACGT-1	CEU
TTGGCAATCATTGCGA-1	CEU
TTGGCAATCCGCGTTT-1	CEU
TTGGCAATCTTTAGGG-1	YRI
TTGTAGGAGGCAGTCA-1	YRI
TTGTAGGCACTGAAGG-1	CEU
TTGTAGGGTCAACATC-1	YRI
TTGTAGGGTGCCTTGG-1	YRI
TTGTAGGTCACATGCA-1	YRI
TTGTAGGTCAGCATGT-1	YRI
TTGTAGGTCTACTATC-1	CEU
TTGTAGGTCTGCCCTA-1	CEU
TTGTAGGTCTGGAGCC-1	CEU
TTTACTGAGCAGACTG-1	YRI
TTTACTGAGGACACCA-1	CEU
TTTACTGAGGATATAC-1	YRI
TTTACTGAGGGATACC-1	CEU
TTTACTGAGTGTGAAT-1	YRI
TTTACTGCATGGGAAC-1	CEU
TTTACTGCATGTAGTC-1	YRI
TTTACTGGTAGAGCTG-1	YRI
TTTACTGGTAGGGACT-1	CEU
TTTACTGTCAGAGACG-1	CEU
TTTACTGTCTTGACGA-1	YRI
TTTATGCAGGACGAAA-1	CEU
TTTATGCCAACTGCGC-1	YRI
TTTATGCGTCACACGC-1	CEU
TTTATGCGTCCCTTGT-1	YRI
TTTATGCGTCTTTCAT-1	CEU
TTTATGCGTTGGTAAA-1	YRI
TTTATGCTCAACCATG-1	YRI
TTTATGCTCATACGGT-1	YRI
TTTATGCTCCATGAAC-1	CEU
TTTCCTCAGACTGGGT-1	CEU
TTTCCTCAGGCGCTCT-1	YRI
TTTCCTCAGGGAGTAA-1	CEU
TTTCCTCAGTGCTGCC-1	CEU
TTTCCTCGTACCATCA-1	YRI
TTTCCTCGTGGTACAG-1	YRI
TTTCCTCTCAAAGACA-1	YRI
TTTCCTCTCCATTCTA-1	YRI
TTTCCTCTCCGGCACA-1	YRI
TTTCCTCTCCTGCAGG-1	CEU
TTTGCGCAGGCCCTCA-1	YRI
TTTGCGCCAAAGCAAT-1	YRI
TTTGCGCCACACCGCA-1	YRI
TTTGCGCCACATAACC-1	CEU
TTTGCGCCAGCGAACA-1	YRI
TTTGCGCGTAGAGGAA-1	YRI
TTTGCGCGTATATGAG-1	CEU
TTTGCGCGTCCAGTAT-1	YRI
TTTGCGCGTGCCTGTG-1	YRI
TTTGCGCGTTCCACGG-1	CEU
TTTGCGCTCATCGGAT-1	CEU
TTTGCGCTCCCACTTG-1	CEU
TTTGCGCTCGAGCCCA-1	CEU
TTTGCGCTCTTATCTG-1	YRI
TTTGGTTAGAACAATC-1	YRI
TTTGGTTAGCCGGTAA-1	YRI
TTTGGTTAGGTGCTTT-1	CEU
TTTGGTTAGTAACCCT-1	CEU
TTTGGTTAGTGGACGT-1	CEU
TTTGGTTTCAGTTGAC-1	CEU
TTTGGTTTCCTTGACC-1	CEU
TTTGGTTTCGGTGTTA-1	YRI
TTTGGTTTCTGCTGTC-1	YRI
TTTGTCAAGACCTTTG-1	CEU
TTTGTCAAGATCTGCT-1	CEU
TTTGTCAAGCACACAG-1	YRI
TTTGTCAAGCATCATC-1	CEU
TTTGTCAAGTATCGAA-1	YRI
TTTGTCAAGTCCAGGA-1	YRI
TTTGTCAAGTCCTCCT-1	YRI
TTTGTCAAGTCGCCGT-1	YRI
TTTGTCACACCTTGTC-1	YRI
TTTGTCACATTGGGCC-1	YRI
TTTGTCAGTACAGTGG-1	YRI
TTTGTCAGTAGTGAAT-1	YRI
TTTGTCAGTCGCTTCT-1	CEU
TTTGTCAGTCGTCTTC-1	YRI
TTTGTCATCCACTGGG-1	CEU
